128,128,128,128,128,2,126,126,126,126,126,1,1,1,1,0,0,0,0,0,0,0,0,0,0,0,1,0,0,125,0,128,6,129
129,129,129,129,129,5,124,124,124,124,124,1,1,1,1,0,0,0,0,0,0,0,0,0,0,0,1,0,0,123,0,129,6,130
130,130,182,130,130,130,52,52,52,52,52,52,52,52,0,0,0,0,0,0,0,0,0,0,0,0,0,52,0,0,0,130,6,131
131,131,131,131,131,2,129,130,129,129,129,1,1,1,1,0,0,0,0,0,0,0,0,0,0,0,1,0,1,128,0,131,6,132
132,132,132,132,132,132,0,0,0,0,0,0,0,0,0,0,0,0,0,0,0,0,0,0,0,0,0,0,0,0,0,132,6,133
133,133,133,133,133,4,129,129,129,129,129,5,5,1,1,0,0,0,0,0,0,0,0,0,0,0,1,0,4,124,0,133,6,134
134,134,134,134,134,134,0,0,0,0,0,0,0,0,0,0,0,0,0,0,0,0,0,0,0,0,0,0,0,0,0,134,6,135
135,135,135,135,135,32,103,103,103,103,103,1,1,1,1,0,0,0,0,0,0,0,0,0,0,0,1,0,0,102,0,135,6,136
136,136,136,136,136,136,0,0,0,0,0,0,0,0,0,0,0,0,0,0,0,0,0,0,0,0,0,0,0,0,0,136,6,137
137,137,138,137,137,35,103,103,103,103,103,2,2,2,1,0,0,0,0,0,0,0,0,0,0,0,1,1,0,101,0,137,6,138
138,138,140,138,138,6,134,134,134,134,134,4,4,3,1,0,0,0,0,0,0,0,0,0,0,0,1,2,1,130,0,138,6,139
139,139,140,139,139,139,1,1,1,1,1,1,1,1,0,0,0,0,0,0,0,0,0,0,0,0,0,1,0,0,0,139,6,140
140,140,146,140,140,24,122,122,122,122,122,7,7,7,1,0,0,0,0,0,0,0,0,0,0,0,1,6,0,115,0,140,6,141
141,141,141,141,141,81,60,60,60,60,60,5,5,5,1,0,0,0,0,0,0,0,0,0,0,0,1,4,0,55,0,141,6,142
142,142,142,142,142,2,140,141,140,140,140,1,1,1,1,0,0,0,0,0,0,0,0,0,0,0,1,0,1,139,0,142,6,143
143,143,143,143,143,100,43,43,43,43,43,2,2,2,2,0,0,0,0,0,0,0,0,0,0,0,2,0,0,41,0,143,6,144
144,144,144,144,144,2,142,142,142,142,142,1,1,1,1,0,0,0,0,0,0,0,0,0,0,0,1,0,0,141,0,144,6,145
145,145,145,145,145,3,142,142,142,142,142,1,1,1,1,0,0,0,0,0,0,0,0,0,0,0,1,0,0,141,0,145,6,146
146,146,146,146,146,146,0,0,0,0,0,0,0,0,0,0,0,0,0,0,0,0,0,0,0,0,0,0,0,0,0,146,6,147
147,147,147,147,147,147,0,0,0,0,0,0,0,0,0,0,0,0,0,0,0,0,0,0,0,0,0,0,0,0,0,147,6,148
148,148,148,148,148,10,138,138,138,138,138,1,1,1,1,0,0,0,0,0,0,0,0,0,0,0,1,0,0,137,0,148,6,149
149,149,149,149,149,4,145,145,145,145,145,3,3,1,1,0,0,0,0,0,0,0,0,0,0,0,1,0,2,142,0,149,6,150
150,150,150,150,150,62,88,88,88,88,88,1,1,1,1,0,0,0,0,0,0,0,0,0,0,0,1,0,0,87,0,150,6,151
151,151,151,151,151,151,0,0,0,0,0,0,0,0,0,0,0,0,0,0,0,0,0,0,0,0,0,0,0,0,0,151,6,152
152,152,152,152,152,6,146,146,146,146,146,2,2,1,1,0,0,0,0,0,0,0,0,0,0,0,1,0,1,144,0,152,6,153
153,153,156,153,153,19,137,138,137,137,137,4,4,4,1,0,0,0,0,0,0,0,0,0,0,0,1,3,1,133,0,153,6,154
154,154,156,154,154,69,87,87,87,87,87,4,4,4,2,0,0,0,0,0,0,0,0,0,0,0,2,2,0,83,0,154,6,155
155,155,155,155,155,9,146,146,146,146,146,2,2,1,1,0,0,0,0,0,0,0,0,0,0,0,1,0,1,144,0,155,6,156
156,156,156,156,156,2,154,154,154,154,154,1,1,1,1,0,0,0,0,0,0,0,0,0,0,0,1,0,0,153,0,156,6,157
157,157,157,157,157,4,153,153,153,153,153,5,5,1,1,0,0,0,0,0,0,0,0,0,0,0,1,0,4,148,0,157,6,158
158,158,158,158,158,158,0,0,0,0,0,0,0,0,0,0,0,0,0,0,0,0,0,0,0,0,0,0,0,0,0,158,6,159
159,159,188,159,159,52,136,137,136,136,136,31,31,31,2,0,0,0,0,0,0,0,0,0,0,0,2,29,1,105,0,159,6,160
160,159,159,159,159,2,157,158,157,157,157,1,1,1,1,0,0,0,0,0,0,0,0,0,0,0,1,0,1,156,0,160,6,161
161,1,1,1,1,1,0,0,0,0,0,0,0,0,0,0,0,0,0,0,0,0,0,0,0,0,0,0,0,0,0,161,5,162
162,1,1,1,1,1,0,0,0,0,0,0,0,0,0,0,0,0,0,0,0,0,0,0,0,0,0,0,0,0,0,162,4,163
163,161,165,161,161,161,4,4,4,4,4,4,4,4,0,0,0,0,0,0,0,0,0,0,0,0,0,4,0,0,0,163,7,164
164,157,158,157,157,22,136,136,136,136,136,3,3,3,1,0,0,0,0,0,0,0,0,0,0,0,1,2,0,133,0,164,6,165
165,3,3,3,3,3,0,0,0,0,0,0,0,0,0,0,0,0,0,0,0,0,0,0,0,0,0,0,0,0,0,165,5,166
166,3,3,3,3,3,0,0,0,0,0,0,0,0,0,0,0,0,0,0,0,0,0,0,0,0,0,0,0,0,0,166,5,167
167,163,163,163,163,163,0,0,0,0,0,0,0,0,0,0,0,0,0,0,0,0,0,0,0,0,0,0,0,0,0,167,5,168
168,155,155,155,155,1,154,155,154,154,154,1,1,0,0,0,0,0,0,0,0,0,0,0,0,0,0,0,1,154,0,168,5,169
169,5,5,5,5,3,2,2,2,2,2,0,0,0,0,0,0,0,0,0,0,0,0,0,0,0,0,0,0,2,0,169,5,170
170,5,5,5,5,1,4,4,4,4,4,0,0,0,0,0,0,0,0,0,0,0,0,0,0,0,0,0,0,4,0,170,5,171
171,165,165,165,165,7,158,158,158,158,158,1,1,1,1,0,0,0,0,0,0,0,0,0,0,0,1,0,0,157,0,171,5,172
172,153,153,153,153,1,152,152,152,152,152,0,0,0,0,0,0,0,0,0,0,0,0,0,0,0,0,0,0,152,0,172,5,173
173,7,7,7,7,1,6,7,6,6,6,1,1,0,0,0,0,0,0,0,0,0,0,0,0,0,0,0,1,6,0,173,5,174
174,7,8,7,7,7,1,1,1,1,1,1,1,1,0,0,0,0,0,0,0,0,0,0,0,0,0,1,0,0,0,174,5,175
175,167,167,167,167,1,166,166,166,166,166,1,1,0,0,0,0,0,0,0,0,0,0,0,0,0,0,0,1,165,0,175,5,176
176,151,151,151,151,1,150,151,150,150,150,1,1,0,0,0,0,0,0,0,0,0,0,0,0,0,0,0,1,150,0,176,5,177
177,9,9,9,9,4,5,5,5,5,5,1,1,1,1,0,0,0,0,0,0,0,0,0,0,0,1,0,0,4,0,177,5,178
178,9,10,9,9,2,8,8,8,8,8,2,2,2,1,0,0,0,0,0,0,0,0,0,0,0,1,1,0,6,0,178,5,179
179,169,169,169,169,6,163,163,163,163,163,0,0,0,0,0,0,0,0,0,0,0,0,0,0,0,0,0,0,163,0,179,5,180
180,149,151,149,149,149,2,2,2,2,2,2,2,2,0,0,0,0,0,0,0,0,0,0,0,0,0,2,0,0,0,180,5,181
181,11,11,11,11,3,8,8,8,8,8,0,0,0,0,0,0,0,0,0,0,0,0,0,0,0,0,0,0,8,0,181,5,182
182,11,11,11,11,11,0,0,0,0,0,0,0,0,0,0,0,0,0,0,0,0,0,0,0,0,0,0,0,0,0,182,5,183
183,171,171,171,171,3,168,168,168,168,168,4,4,0,0,0,0,0,0,0,0,0,0,0,0,0,0,0,4,164,0,183,5,184
184,147,147,147,147,1,146,146,146,146,146,1,1,0,0,0,0,0,0,0,0,0,0,0,0,0,0,0,1,145,0,184,5,185
185,13,13,13,13,13,0,0,0,0,0,0,0,0,0,0,0,0,0,0,0,0,0,0,0,0,0,0,0,0,0,185,5,186
186,13,13,13,13,2,11,11,11,11,11,1,1,1,1,0,0,0,0,0,0,0,0,0,0,0,1,0,0,10,0,186,5,187
187,173,173,173,173,6,167,167,167,167,167,0,0,0,0,0,0,0,0,0,0,0,0,0,0,0,0,0,0,167,0,187,5,188
188,145,146,145,145,2,144,144,144,144,144,2,2,2,1,0,0,0,0,0,0,0,0,0,0,0,1,1,0,142,0,188,5,189
189,15,17,15,15,15,2,2,2,2,2,2,2,2,0,0,0,0,0,0,0,0,0,0,0,0,0,2,0,0,0,189,5,190
190,15,15,15,15,15,0,0,0,0,0,0,0,0,0,0,0,0,0,0,0,0,0,0,0,0,0,0,0,0,0,190,5,191
191,175,175,175,175,1,174,175,174,174,174,2,1,0,0,0,0,0,0,0,0,0,0,0,0,0,0,0,2,173,0,191,5,192
192,151,151,151,151,1,150,150,150,150,150,2,2,1,1,0,0,0,0,0,0,0,0,0,0,0,1,0,1,148,0,192,5,193
193,25,25,25,25,4,21,21,21,21,21,1,1,1,1,0,0,0,0,0,0,0,0,0,0,0,1,0,0,20,0,193,5,194
194,185,185,185,185,5,180,180,180,180,180,2,2,2,1,0,0,0,0,0,0,0,0,0,0,0,1,1,0,178,0,194,5,195
195,182,182,182,182,2,180,180,180,180,180,2,2,1,1,0,0,0,0,0,0,0,0,0,0,0,1,0,1,178,0,195,5,196
196,150,150,150,150,1,149,151,149,149,149,2,2,1,1,0,0,0,0,0,0,0,0,0,0,0,1,0,2,148,0,196,5,197
197,28,32,28,28,28,4,4,4,4,4,4,4,4,0,0,0,0,0,0,0,0,0,0,0,0,0,4,0,0,0,197,5,198
198,188,204,188,188,187,17,17,17,17,17,17,17,17,1,0,0,0,0,0,0,0,0,0,0,0,1,16,0,0,0,198,5,199
199,181,181,181,181,1,180,181,180,180,180,2,2,1,1,0,0,0,0,0,0,0,0,0,0,0,1,0,2,178,0,199,5,200
200,149,149,149,149,1,148,148,148,148,148,2,2,1,1,0,0,0,0,0,0,0,0,0,0,0,1,0,1,146,0,200,5,201
201,31,31,31,31,31,0,0,0,0,0,0,0,0,0,0,0,0,0,0,0,0,0,0,0,0,0,0,0,0,0,201,5,202
202,191,192,191,191,6,186,186,186,186,186,3,3,2,1,0,0,0,0,0,0,0,0,0,0,0,1,1,1,183,0,202,5,203
203,180,180,180,180,7,173,173,173,173,173,2,2,1,1,0,0,0,0,0,0,0,0,0,0,0,1,0,1,171,0,203,5,204
204,148,148,148,148,1,147,148,147,147,147,2,2,1,1,0,0,0,0,0,0,0,0,0,0,0,1,0,2,145,0,204,5,205
205,34,34,34,34,1,33,34,33,33,33,2,2,1,1,0,0,0,0,0,0,0,0,0,0,0,1,0,2,31,0,205,5,206
206,194,194,194,194,194,0,0,0,0,0,0,0,0,0,0,0,0,0,0,0,0,0,0,0,0,0,0,0,0,0,206,5,207
207,179,181,179,179,120,61,61,61,61,61,4,4,4,2,0,0,0,0,0,0,0,0,0,0,0,2,2,0,57,0,207,5,208
208,147,147,147,147,4,143,143,143,143,143,1,1,1,1,0,0,0,0,0,0,0,0,0,0,0,1,0,0,142,0,208,5,209
209,37,37,37,37,6,31,31,31,31,31,1,1,1,1,0,0,0,0,0,0,0,0,0,0,0,1,0,0,30,0,209,5,210
210,197,198,197,197,197,1,1,1,1,1,1,1,1,0,0,0,0,0,0,0,0,0,0,0,0,0,1,0,0,0,210,5,211
211,178,178,178,178,1,177,178,177,177,177,1,1,1,1,0,0,0,0,0,0,0,0,0,0,0,1,0,1,176,0,211,5,212
212,146,146,146,146,146,0,0,0,0,0,0,0,0,0,0,0,0,0,0,0,0,0,0,0,0,0,0,0,0,0,212,5,213
213,40,40,40,40,1,39,39,39,39,39,2,2,1,1,0,0,0,0,0,0,0,0,0,0,0,1,0,1,37,0,213,5,214
214,200,200,200,200,1,199,200,199,199,199,1,1,1,1,0,0,0,0,0,0,0,0,0,0,0,1,0,1,198,0,214,5,215
215,177,177,177,177,1,176,177,176,176,176,2,2,1,1,0,0,0,0,0,0,0,0,0,0,0,1,0,2,174,0,215,5,216
216,145,145,145,145,1,144,145,144,144,144,2,2,1,1,0,0,0,0,0,0,0,0,0,0,0,1,0,2,142,0,216,5,217
217,43,43,43,43,4,39,39,39,39,39,2,2,1,1,0,0,0,0,0,0,0,0,0,0,0,1,0,1,37,0,217,5,218
218,203,203,203,203,4,199,199,199,199,199,2,2,1,1,0,0,0,0,0,0,0,0,0,0,0,1,0,1,197,0,218,5,219
219,176,176,176,176,176,0,0,0,0,0,0,0,0,0,0,0,0,0,0,0,0,0,0,0,0,0,0,0,0,0,219,5,220
220,144,145,144,144,6,139,139,139,139,139,2,2,2,1,0,0,0,0,0,0,0,0,0,0,0,1,1,0,137,0,220,5,221
221,46,46,46,46,1,45,45,45,45,45,2,2,1,1,0,0,0,0,0,0,0,0,0,0,0,1,0,1,43,0,221,5,222
222,206,325,206,206,205,120,120,120,120,120,120,120,120,1,0,0,0,0,0,0,0,0,0,0,0,1,119,0,0,0,222,5,223
223,175,182,175,175,18,164,165,164,164,164,8,8,8,1,0,0,0,0,0,0,0,0,0,0,0,1,7,1,156,0,223,5,224
224,159,159,159,159,2,157,157,157,157,157,1,1,1,1,0,0,0,0,0,0,0,0,0,0,0,1,0,0,156,0,224,5,225
225,223,223,223,223,2,221,221,221,221,221,1,1,1,1,0,0,0,0,0,0,0,0,0,0,0,1,0,0,220,0,225,6,226
226,159,159,159,159,159,0,0,0,0,0,0,0,0,0,0,0,0,0,0,0,0,0,0,0,0,0,0,0,0,0,226,5,227
227,223,223,223,223,2,221,222,221,221,221,1,1,1,1,0,0,0,0,0,0,0,0,0,0,0,1,0,1,220,0,227,6,228
228,159,159,159,159,2,157,159,157,157,157,2,2,1,1,0,0,0,0,0,0,0,0,0,0,0,1,0,2,156,0,228,5,229
229,223,223,223,223,6,217,217,217,217,217,1,1,1,1,0,0,0,0,0,0,0,0,0,0,0,1,0,0,216,0,229,6,230
230,159,159,159,159,2,157,159,157,157,157,2,2,1,1,0,0,0,0,0,0,0,0,0,0,0,1,0,2,156,0,230,5,231
231,223,223,223,223,223,0,0,0,0,0,0,0,0,0,0,0,0,0,0,0,0,0,0,0,0,0,0,0,0,0,231,5,232
232,159,159,159,159,2,157,158,157,157,157,1,1,1,1,0,0,0,0,0,0,0,0,0,0,0,1,0,1,156,0,232,5,233
233,223,225,223,223,6,219,219,219,219,219,3,3,3,1,0,0,0,0,0,0,0,0,0,0,0,1,2,0,216,0,233,5,234
234,159,159,159,159,2,157,157,157,157,157,2,2,1,1,0,0,0,0,0,0,0,0,0,0,0,1,0,1,155,0,234,5,235
235,223,226,223,223,223,3,3,3,3,3,3,3,3,0,0,0,0,0,0,0,0,0,0,0,0,0,3,0,0,0,235,5,236
236,159,159,159,159,159,0,0,0,0,0,0,0,0,0,0,0,0,0,0,0,0,0,0,0,0,0,0,0,0,0,236,5,237
237,223,225,223,223,6,219,220,219,219,219,3,3,3,1,0,0,0,0,0,0,0,0,0,0,0,1,2,1,216,0,237,5,238
238,159,163,159,159,159,4,4,4,4,4,4,4,4,0,0,0,0,0,0,0,0,0,0,0,0,0,4,0,0,0,238,5,239
239,223,276,223,223,77,199,201,199,199,199,56,56,56,3,0,0,0,0,0,0,0,0,0,0,0,3,53,2,143,0,239,5,240
240,159,159,159,159,5,154,154,154,154,154,2,2,2,1,0,0,0,0,0,0,0,0,0,0,0,1,1,0,152,0,240,5,241
241,223,224,223,223,6,218,218,218,218,218,2,2,2,1,0,0,0,0,0,0,0,0,0,0,0,1,1,0,216,0,241,5,242
242,159,160,159,159,159,1,1,1,1,1,1,1,1,0,0,0,0,0,0,0,0,0,0,0,0,0,1,0,0,0,242,5,243
243,223,224,223,223,223,1,1,1,1,1,1,1,1,0,0,0,0,0,0,0,0,0,0,0,0,0,1,0,0,0,243,5,244
244,159,163,159,159,74,89,89,89,89,89,5,5,5,1,0,0,0,0,0,0,0,0,0,0,0,1,4,0,84,0,244,5,245
245,223,223,223,223,2,221,222,221,221,221,2,2,1,1,0,0,0,0,0,0,0,0,0,0,0,1,0,2,219,0,245,5,246
246,159,159,159,159,2,157,159,157,157,157,2,2,1,1,0,0,0,0,0,0,0,0,0,0,0,1,0,2,156,0,246,5,247
247,223,223,223,223,2,221,222,221,221,221,1,1,1,1,0,0,0,0,0,0,0,0,0,0,0,1,0,1,220,0,247,5,248
248,159,159,159,159,2,157,157,157,157,157,2,2,1,1,0,0,0,0,0,0,0,0,0,0,0,1,0,1,155,0,248,5,249
249,223,223,223,223,223,0,0,0,0,0,0,0,0,0,0,0,0,0,0,0,0,0,0,0,0,0,0,0,0,0,249,5,250
250,159,159,159,159,2,157,157,157,157,157,1,1,1,1,0,0,0,0,0,0,0,0,0,0,0,1,0,0,156,0,250,5,251
251,223,230,223,223,223,7,7,7,7,7,7,7,7,0,0,0,0,0,0,0,0,0,0,0,0,0,7,0,0,0,251,5,252
252,159,160,159,159,14,146,146,146,146,146,2,2,2,1,0,0,0,0,0,0,0,0,0,0,0,1,1,0,144,0,252,5,253
253,223,223,223,223,2,221,222,221,221,221,1,1,1,1,0,0,0,0,0,0,0,0,0,0,0,1,0,1,220,0,253,5,254
254,159,159,159,159,7,152,152,152,152,152,2,2,2,1,0,0,0,0,0,0,0,0,0,0,0,1,1,0,150,0,254,5,255
255,223,223,223,223,2,221,221,221,221,221,1,0,0,0,0,0,0,0,0,0,0,0,0,0,0,0,0,1,220,0,255,5,256
256,159,159,159,159,4,155,155,155,155,155,1,1,1,1,0,0,0,0,0,0,0,0,0,0,0,1,0,0,154,0,256,5,257
257,223,223,223,223,2,221,222,221,221,221,1,1,1,1,0,0,0,0,0,0,0,0,0,0,0,1,0,1,220,0,257,5,258
258,159,160,159,159,6,154,156,154,154,154,3,3,2,1,0,0,0,0,0,0,0,0,0,0,0,1,1,2,152,0,258,5,259
259,223,223,223,223,4,219,219,219,219,219,1,1,1,1,0,0,0,0,0,0,0,0,0,0,0,1,0,0,218,0,259,5,260
260,159,160,159,159,6,154,155,154,154,154,2,2,2,1,0,0,0,0,0,0,0,0,0,0,0,1,1,1,152,0,260,5,261
261,223,227,223,223,223,4,4,4,4,4,4,4,4,0,0,0,0,0,0,0,0,0,0,0,0,0,4,0,0,0,261,5,262
262,159,159,159,159,159,0,0,0,0,0,0,0,0,0,0,0,0,0,0,0,0,0,0,0,0,0,0,0,0,0,262,5,263
263,223,223,223,223,2,221,222,221,221,221,1,1,1,1,0,0,0,0,0,0,0,0,0,0,0,1,0,1,220,0,263,5,264
264,159,159,159,159,2,157,158,157,157,157,1,1,1,1,0,0,0,0,0,0,0,0,0,0,0,1,0,1,156,0,264,5,265
265,223,230,223,223,223,7,7,7,7,7,7,7,7,0,0,0,0,0,0,0,0,0,0,0,0,0,7,0,0,0,265,5,266
266,159,161,159,159,16,145,145,145,145,145,3,3,3,1,0,0,0,0,0,0,0,0,0,0,0,1,2,0,142,0,266,5,267
267,255,255,255,255,4,251,251,251,251,251,2,2,1,1,0,0,0,0,0,0,0,0,0,0,0,1,0,1,249,0,267,6,268
268,159,160,159,159,5,155,156,155,155,155,2,2,2,1,0,0,0,0,0,0,0,0,0,0,0,1,1,1,153,0,268,5,269
269,223,223,223,223,223,0,0,0,0,0,0,0,0,0,0,0,0,0,0,0,0,0,0,0,0,0,0,0,0,0,269,5,270
270,159,160,159,159,22,138,139,138,138,138,2,2,2,1,0,0,0,0,0,0,0,0,0,0,0,1,1,1,136,0,270,5,271
271,223,224,223,223,17,207,207,207,207,207,2,2,2,1,0,0,0,0,0,0,0,0,0,0,0,1,1,0,205,0,271,5,272
272,159,159,159,159,6,153,153,153,153,153,1,1,1,1,0,0,0,0,0,0,0,0,0,0,0,1,0,0,152,0,272,5,273
273,223,227,223,223,223,4,4,4,4,4,4,4,4,0,0,0,0,0,0,0,0,0,0,0,0,0,4,0,0,0,273,5,274
274,159,167,159,159,32,135,136,135,135,135,9,9,9,1,0,0,0,0,0,0,0,0,0,0,0,1,8,1,126,0,274,5,275
275,223,224,223,223,18,206,206,206,206,206,2,2,2,1,0,0,0,0,0,0,0,0,0,0,0,1,1,0,204,0,275,5,276
276,159,159,159,159,30,129,129,129,129,129,1,1,1,1,0,0,0,0,0,0,0,0,0,0,0,1,0,0,128,0,276,5,277
277,223,224,223,223,4,220,221,220,220,220,3,3,2,1,0,0,0,0,0,0,0,0,0,0,0,1,1,1,218,0,277,5,278
278,159,164,159,159,64,100,100,100,100,100,6,6,6,1,0,0,0,0,0,0,0,0,0,0,0,1,5,0,94,0,278,5,279
279,223,224,223,223,223,1,1,1,1,1,1,1,1,0,0,0,0,0,0,0,0,0,0,0,0,0,1,0,0,0,279,5,280
280,223,225,223,223,223,2,2,2,2,2,2,2,2,0,0,0,0,0,0,0,0,0,0,0,0,0,2,0,0,0,280,5,281
281,223,226,223,223,12,214,214,214,214,214,4,4,4,1,0,0,0,0,0,0,0,0,0,0,0,1,3,0,210,0,281,5,282
282,159,161,159,159,159,2,2,2,2,2,2,2,2,0,0,0,0,0,0,0,0,0,0,0,0,0,2,0,0,0,282,5,283
283,223,223,223,223,44,179,179,179,179,179,1,1,1,1,0,0,0,0,0,0,0,0,0,0,0,1,0,0,178,0,283,5,284
284,159,162,159,159,10,152,152,152,152,152,4,4,4,1,0,0,0,0,0,0,0,0,0,0,0,1,3,0,148,0,284,5,285
285,223,223,223,223,2,221,222,221,221,221,1,1,1,1,0,0,0,0,0,0,0,0,0,0,0,1,0,1,220,0,285,5,286
286,159,169,159,159,159,10,10,10,10,10,10,10,10,0,0,0,0,0,0,0,0,0,0,0,0,0,10,0,0,0,286,5,287
287,223,249,223,223,54,195,195,195,195,195,27,27,27,1,0,0,0,0,0,0,0,0,0,0,0,1,26,0,168,0,287,5,288
288,159,161,159,159,159,2,2,2,2,2,2,2,2,0,0,0,0,0,0,0,0,0,0,0,0,0,2,0,0,0,288,5,289
289,191,191,191,191,2,189,189,189,189,189,1,1,1,1,0,0,0,0,0,0,0,0,0,0,0,1,0,0,188,0,289,6,290
290,223,223,223,223,223,0,0,0,0,0,0,0,0,0,0,0,0,0,0,0,0,0,0,0,0,0,0,0,0,0,290,5,291
291,255,255,255,255,2,253,254,253,253,253,1,1,1,1,0,0,0,0,0,0,0,0,0,0,0,1,0,1,252,0,291,6,292
292,159,160,159,159,159,1,1,1,1,1,1,1,1,0,0,0,0,0,0,0,0,0,0,0,0,0,1,0,0,0,292,5,293
293,191,191,191,191,191,0,0,0,0,0,0,0,0,0,0,0,0,0,0,0,0,0,0,0,0,0,0,0,0,0,293,6,294
294,223,223,223,223,26,197,197,197,197,197,1,1,1,1,0,0,0,0,0,0,0,0,0,0,0,1,0,0,196,0,294,6,295
295,255,255,255,255,255,0,0,0,0,0,0,0,0,0,0,0,0,0,0,0,0,0,0,0,0,0,0,0,0,0,295,6,296
296,159,159,159,159,159,0,0,0,0,0,0,0,0,0,0,0,0,0,0,0,0,0,0,0,0,0,0,0,0,0,296,6,297
297,191,191,191,191,6,185,185,185,185,185,1,1,1,1,0,0,0,0,0,0,0,0,0,0,0,1,0,0,184,0,297,6,298
298,223,223,223,223,223,0,0,0,0,0,0,0,0,0,0,0,0,0,0,0,0,0,0,0,0,0,0,0,0,0,298,6,299
299,255,255,255,255,4,251,251,251,251,251,2,2,1,1,0,0,0,0,0,0,0,0,0,0,0,1,0,1,249,0,299,6,300
300,159,159,159,159,4,155,156,155,155,155,1,1,1,1,0,0,0,0,0,0,0,0,0,0,0,1,0,1,154,0,300,6,301
301,191,191,191,191,32,159,159,159,159,159,1,1,1,1,0,0,0,0,0,0,0,0,0,0,0,1,0,0,158,0,301,6,302
302,223,227,223,223,10,217,217,217,217,217,5,5,5,1,0,0,0,0,0,0,0,0,0,0,0,1,4,0,212,0,302,6,303
303,255,315,255,255,176,139,139,139,139,139,62,62,62,2,0,0,0,0,0,0,0,0,0,0,0,2,60,0,77,0,303,6,304
304,159,167,159,159,159,8,8,8,8,8,8,8,8,0,0,0,0,0,0,0,0,0,0,0,0,0,8,0,0,0,304,6,305
305,191,191,191,191,6,185,185,185,185,185,2,2,1,1,0,0,0,0,0,0,0,0,0,0,0,1,0,1,183,0,305,6,306
306,223,224,223,223,223,1,1,1,1,1,1,1,1,0,0,0,0,0,0,0,0,0,0,0,0,0,1,0,0,0,306,6,307
307,255,256,255,255,10,246,247,246,246,246,2,2,2,1,0,0,0,0,0,0,0,0,0,0,0,1,1,1,244,0,307,6,308
308,159,159,159,159,159,0,0,0,0,0,0,0,0,0,0,0,0,0,0,0,0,0,0,0,0,0,0,0,0,0,308,6,309
309,191,191,191,191,36,155,155,155,155,155,1,1,1,1,0,0,0,0,0,0,0,0,0,0,0,1,0,0,154,0,309,6,310
310,223,223,223,223,2,221,222,221,221,221,1,1,1,1,0,0,0,0,0,0,0,0,0,0,0,1,0,1,220,0,310,6,311
311,191,191,191,191,6,185,185,185,185,185,2,2,1,1,0,0,0,0,0,0,0,0,0,0,0,1,0,1,183,0,311,4,312
312,159,159,159,159,20,139,139,139,139,139,1,1,1,1,0,0,0,0,0,0,0,0,0,0,0,1,0,0,138,0,312,6,313
313,191,191,191,191,2,189,189,189,189,189,1,1,1,1,0,0,0,0,0,0,0,0,0,0,0,1,0,0,188,0,313,6,314
314,223,223,223,223,6,217,217,217,217,217,2,2,1,1,0,0,0,0,0,0,0,0,0,0,0,1,0,1,215,0,314,6,315
315,255,255,255,255,4,251,251,251,251,251,2,2,1,1,0,0,0,0,0,0,0,0,0,0,0,1,0,1,249,0,315,6,316
316,159,159,159,159,159,0,0,0,0,0,0,0,0,0,0,0,0,0,0,0,0,0,0,0,0,0,0,0,0,0,316,6,317
317,191,191,191,191,191,0,0,0,0,0,0,0,0,0,0,0,0,0,0,0,0,0,0,0,0,0,0,0,0,0,317,6,318
318,223,224,223,223,40,184,184,184,184,184,2,2,2,1,0,0,0,0,0,0,0,0,0,0,0,1,1,0,182,0,318,6,319
319,255,273,255,255,30,243,244,243,243,243,19,19,19,1,0,0,0,0,0,0,0,0,0,0,0,1,18,1,224,0,319,6,320
320,160,179,160,160,160,19,19,19,19,19,19,19,19,0,0,0,0,0,0,0,0,0,0,0,0,0,19,0,0,0,320,6,321
321,161,161,161,161,2,159,160,159,159,159,1,1,1,1,0,0,0,0,0,0,0,0,0,0,0,1,0,1,158,0,321,7,322
322,162,162,162,162,2,160,161,160,160,160,1,1,1,1,0,0,0,0,0,0,0,0,0,0,0,1,0,1,159,0,322,4,323
323,162,162,162,162,2,160,160,160,160,160,1,1,1,1,0,0,0,0,0,0,0,0,0,0,0,1,0,0,159,0,323,5,324
324,163,163,163,163,2,161,163,161,161,161,2,2,1,1,0,0,0,0,0,0,0,0,0,0,0,1,0,2,160,0,324,6,325
325,164,165,164,164,34,131,131,131,131,131,2,2,2,1,0,0,0,0,0,0,0,0,0,0,0,1,1,0,129,0,325,7,326
326,165,165,165,165,165,0,0,0,0,0,0,0,0,0,0,0,0,0,0,0,0,0,0,0,0,0,0,0,0,0,326,6,327
327,165,168,165,165,165,3,3,3,3,3,3,3,3,0,0,0,0,0,0,0,0,0,0,0,0,0,3,0,0,0,327,6,328
328,166,166,166,166,2,164,164,164,164,164,2,2,1,1,0,0,0,0,0,0,0,0,0,0,0,1,0,1,162,0,328,6,329
329,189,190,189,189,18,172,172,172,172,172,2,2,2,1,0,0,0,0,0,0,0,0,0,0,0,1,1,0,170,0,329,7,330
330,168,168,168,168,2,166,168,166,166,166,2,2,1,1,0,0,0,0,0,0,0,0,0,0,0,1,0,2,165,0,330,6,331
331,168,170,168,168,168,2,2,2,2,2,2,2,2,0,0,0,0,0,0,0,0,0,0,0,0,0,2,0,0,0,331,6,332
332,169,169,169,169,2,167,168,167,167,167,1,1,1,1,0,0,0,0,0,0,0,0,0,0,0,1,0,1,166,0,332,6,333
333,170,171,170,170,170,1,1,1,1,1,1,1,1,0,0,0,0,0,0,0,0,0,0,0,0,0,1,0,0,0,333,6,334
334,171,171,171,171,171,0,0,0,0,0,0,0,0,0,0,0,0,0,0,0,0,0,0,0,0,0,0,0,0,0,334,6,335
335,171,220,171,171,126,94,94,94,94,94,50,50,50,1,0,0,0,0,0,0,0,0,0,0,0,1,49,0,44,0,335,6,336
336,172,181,172,172,16,165,167,165,165,165,11,11,10,1,0,0,0,0,0,0,0,0,0,0,0,1,9,2,155,0,336,6,337
337,173,173,173,173,2,171,173,171,171,171,2,2,1,1,0,0,0,0,0,0,0,0,0,0,0,1,0,2,170,0,337,6,338
338,174,174,174,174,2,172,173,172,172,172,1,1,1,1,0,0,0,0,0,0,0,0,0,0,0,1,0,1,171,0,338,6,339
339,174,174,174,174,6,168,168,168,168,168,1,1,1,1,0,0,0,0,0,0,0,0,0,0,0,1,0,0,167,0,339,6,340
340,175,175,175,175,2,173,175,173,173,173,2,2,1,1,0,0,0,0,0,0,0,0,0,0,0,1,0,2,172,0,340,6,341
341,176,176,176,176,2,174,175,174,174,174,1,1,1,1,0,0,0,0,0,0,0,0,0,0,0,1,0,1,173,0,341,6,342
342,177,177,177,177,6,171,173,171,171,171,2,2,1,1,0,0,0,0,0,0,0,0,0,0,0,1,0,2,170,0,342,6,343
343,177,177,177,177,8,169,169,169,169,169,1,1,1,1,0,0,0,0,0,0,0,0,0,0,0,1,0,0,168,0,343,6,344
344,178,179,178,178,178,1,1,1,1,1,1,1,1,0,0,0,0,0,0,0,0,0,0,0,0,0,1,0,0,0,344,6,345
345,179,179,179,179,2,177,178,177,177,177,1,1,1,1,0,0,0,0,0,0,0,0,0,0,0,1,0,1,176,0,345,6,346
346,184,190,184,184,36,154,154,154,154,154,7,7,7,1,0,0,0,0,0,0,0,0,0,0,0,1,6,0,147,0,346,7,347
347,180,180,180,180,2,178,180,178,178,178,2,2,1,1,0,0,0,0,0,0,0,0,0,0,0,1,0,2,177,0,347,6,348
348,181,181,181,181,8,173,173,173,173,173,1,1,1,1,0,0,0,0,0,0,0,0,0,0,0,1,0,0,172,0,348,6,349
349,182,191,182,182,18,173,174,173,173,173,10,10,10,1,0,0,0,0,0,0,0,0,0,0,0,1,9,1,163,0,349,6,350
350,183,187,183,183,183,4,4,4,4,4,4,4,4,0,0,0,0,0,0,0,0,0,0,0,0,0,4,0,0,0,350,6,351
351,183,183,183,183,2,181,181,181,181,181,2,2,1,1,0,0,0,0,0,0,0,0,0,0,0,1,0,1,179,0,351,6,352
352,183,183,183,183,42,141,141,141,141,141,2,2,1,1,0,0,0,0,0,0,0,0,0,0,0,1,0,1,139,0,352,6,353
353,184,184,184,184,2,182,184,182,182,182,2,2,1,1,0,0,0,0,0,0,0,0,0,0,0,1,0,2,181,0,353,6,354
354,185,185,185,185,185,0,0,0,0,0,0,0,0,0,0,0,0,0,0,0,0,0,0,0,0,0,0,0,0,0,354,6,355
355,185,185,185,185,8,177,177,177,177,177,1,1,1,1,0,0,0,0,0,0,0,0,0,0,0,1,0,0,176,0,355,6,356
356,185,185,185,185,6,179,179,179,179,179,1,1,1,1,0,0,0,0,0,0,0,0,0,0,0,1,0,0,178,0,356,6,357
357,186,186,186,186,4,182,182,182,182,182,2,2,1,1,0,0,0,0,0,0,0,0,0,0,0,1,0,1,180,0,357,6,358
358,187,190,187,187,52,138,139,138,138,138,4,4,4,1,0,0,0,0,0,0,0,0,0,0,0,1,3,1,134,0,358,6,359
359,187,187,187,187,6,181,181,181,181,181,1,1,1,1,0,0,0,0,0,0,0,0,0,0,0,1,0,0,180,0,359,6,360
360,187,187,187,187,2,185,185,185,185,185,1,1,1,1,0,0,0,0,0,0,0,0,0,0,0,1,0,0,184,0,360,6,361
361,241,241,241,241,241,0,0,0,0,0,0,0,0,0,0,0,0,0,0,0,0,0,0,0,0,0,0,0,0,0,361,5,362
362,209,209,209,209,209,0,0,0,0,0,0,0,0,0,0,0,0,0,0,0,0,0,0,0,0,0,0,0,0,0,362,4,363
363,189,189,189,189,6,183,183,183,183,183,1,1,1,1,0,0,0,0,0,0,0,0,0,0,0,1,0,0,182,0,363,7,364
364,189,190,189,189,12,178,178,178,178,178,2,2,2,1,0,0,0,0,0,0,0,0,0,0,0,1,1,0,176,0,364,6,365
365,239,239,239,239,239,0,0,0,0,0,0,0,0,0,0,0,0,0,0,0,0,0,0,0,0,0,0,0,0,0,365,5,366
366,207,207,207,207,2,205,205,205,205,205,2,2,1,1,0,0,0,0,0,0,0,0,0,0,0,1,0,1,203,0,366,5,367
367,191,191,191,191,6,185,185,185,185,185,1,1,1,1,0,0,0,0,0,0,0,0,0,0,0,1,0,0,184,0,367,5,368
368,191,207,191,191,191,16,16,16,16,16,16,16,16,0,0,0,0,0,0,0,0,0,0,0,0,0,16,0,0,0,368,5,369
369,237,237,237,237,2,235,236,235,235,235,2,2,1,1,0,0,0,0,0,0,0,0,0,0,0,1,0,2,233,0,369,5,370
370,205,205,205,205,205,0,0,0,0,0,0,0,0,0,0,0,0,0,0,0,0,0,0,0,0,0,0,0,0,0,370,5,371
371,193,193,193,193,32,161,161,161,161,161,1,1,1,1,0,0,0,0,0,0,0,0,0,0,0,1,0,0,160,0,371,5,372
372,193,193,193,193,193,0,0,0,0,0,0,0,0,0,0,0,0,0,0,0,0,0,0,0,0,0,0,0,0,0,372,5,373
373,235,235,235,235,4,231,231,231,231,231,2,2,1,1,0,0,0,0,0,0,0,0,0,0,0,1,0,1,229,0,373,5,374
374,203,206,203,203,203,3,3,3,3,3,3,3,3,0,0,0,0,0,0,0,0,0,0,0,0,0,3,0,0,0,374,5,375
375,195,195,195,195,6,189,190,189,189,189,1,1,1,1,0,0,0,0,0,0,0,0,0,0,0,1,0,1,188,0,375,5,376
376,195,196,195,195,195,1,1,1,1,1,1,1,1,0,0,0,0,0,0,0,0,0,0,0,0,0,1,0,0,0,376,5,377
377,196,196,196,196,4,192,192,192,192,192,2,2,1,1,0,0,0,0,0,0,0,0,0,0,0,1,0,1,190,0,377,6,378
378,201,201,201,201,201,0,0,0,0,0,0,0,0,0,0,0,0,0,0,0,0,0,0,0,0,0,0,0,0,0,378,5,379
379,197,212,197,197,197,15,15,15,15,15,15,15,15,0,0,0,0,0,0,0,0,0,0,0,0,0,15,0,0,0,379,5,380
380,197,197,197,197,2,195,196,195,195,195,1,1,1,1,0,0,0,0,0,0,0,0,0,0,0,1,0,1,194,0,380,5,381
381,231,232,231,231,58,174,174,174,174,174,2,2,2,1,0,0,0,0,0,0,0,0,0,0,0,1,1,0,172,0,381,5,382
382,199,199,199,199,6,193,193,193,193,193,1,1,1,1,0,0,0,0,0,0,0,0,0,0,0,1,0,0,192,0,382,5,383
383,199,200,199,199,3,197,198,197,197,197,3,2,1,0,0,0,0,0,0,0,0,0,0,0,0,0,1,2,195,0,383,5,384
384,199,201,199,199,199,2,2,2,2,2,2,2,2,0,0,0,0,0,0,0,0,0,0,0,0,0,2,0,0,0,384,5,385
385,230,230,230,230,2,228,228,228,228,228,2,2,1,1,0,0,0,0,0,0,0,0,0,0,0,1,0,1,226,0,385,5,386
386,199,199,199,199,3,196,196,196,196,196,2,2,1,1,0,0,0,0,0,0,0,0,0,0,0,1,0,1,194,0,386,5,387
387,199,199,199,199,6,193,193,193,193,193,1,1,1,1,0,0,0,0,0,0,0,0,0,0,0,1,0,0,192,0,387,6,388
388,199,202,199,199,199,3,3,3,3,3,3,3,3,0,0,0,0,0,0,0,0,0,0,0,0,0,3,0,0,0,388,5,389
389,228,229,228,228,6,223,223,223,223,223,2,2,2,1,0,0,0,0,0,0,0,0,0,0,0,1,1,0,221,0,389,5,390
390,199,200,199,199,199,1,1,1,1,1,1,1,1,0,0,0,0,0,0,0,0,0,0,0,0,0,1,0,0,0,390,5,391
391,203,203,203,203,3,200,200,200,200,200,2,2,1,1,0,0,0,0,0,0,0,0,0,0,0,1,0,1,198,0,391,5,392
392,199,199,199,199,2,197,198,197,197,197,2,2,1,1,0,0,0,0,0,0,0,0,0,0,0,1,0,2,195,0,392,5,393
393,200,200,200,200,2,198,200,198,198,198,2,2,1,1,0,0,0,0,0,0,0,0,0,0,0,1,0,2,197,0,393,6,394
394,199,199,199,199,18,181,181,181,181,181,1,1,1,1,0,0,0,0,0,0,0,0,0,0,0,1,0,0,180,0,394,5,395
395,199,203,199,199,199,4,4,4,4,4,4,4,4,0,0,0,0,0,0,0,0,0,0,0,0,0,4,0,0,0,395,6,396
396,199,199,199,199,3,196,196,196,196,196,2,2,1,1,0,0,0,0,0,0,0,0,0,0,0,1,0,1,194,0,396,5,397
397,224,252,224,224,224,28,28,28,28,28,28,28,28,0,0,0,0,0,0,0,0,0,0,0,0,0,28,0,0,0,397,5,398
398,199,214,199,199,50,164,165,164,164,164,16,16,16,1,0,0,0,0,0,0,0,0,0,0,0,1,15,1,148,0,398,5,399
399,199,199,199,199,2,197,199,197,197,197,2,2,1,1,0,0,0,0,0,0,0,0,0,0,0,1,0,2,196,0,399,5,400
400,199,200,199,199,199,1,1,1,1,1,1,1,1,0,0,0,0,0,0,0,0,0,0,0,0,0,1,0,0,0,400,5,401
401,200,200,200,200,2,198,198,198,198,198,2,2,1,1,0,0,0,0,0,0,0,0,0,0,0,1,0,1,196,0,401,5,402
402,199,200,199,199,199,1,1,1,1,1,1,1,1,0,0,0,0,0,0,0,0,0,0,0,0,0,1,0,0,0,402,5,403
403,199,199,199,199,199,0,0,0,0,0,0,0,0,0,0,0,0,0,0,0,0,0,0,0,0,0,0,0,0,0,403,5,404
404,199,199,199,199,199,0,0,0,0,0,0,0,0,0,0,0,0,0,0,0,0,0,0,0,0,0,0,0,0,0,404,5,405
405,220,220,220,220,6,214,214,214,214,214,2,2,1,1,0,0,0,0,0,0,0,0,0,0,0,1,0,1,212,0,405,6,406
406,199,199,199,199,199,0,0,0,0,0,0,0,0,0,0,0,0,0,0,0,0,0,0,0,0,0,0,0,0,0,406,5,407
407,199,200,199,199,10,190,191,190,190,190,3,3,2,1,0,0,0,0,0,0,0,0,0,0,0,1,1,2,187,0,407,5,408
408,199,206,199,199,199,7,7,7,7,7,7,7,7,0,0,0,0,0,0,0,0,0,0,0,0,0,7,0,0,0,408,5,409
409,200,200,200,200,2,198,200,198,198,198,2,2,1,1,0,0,0,0,0,0,0,0,0,0,0,1,0,2,197,0,409,5,410
410,199,199,199,199,2,197,197,197,197,197,2,2,1,1,0,0,0,0,0,0,0,0,0,0,0,1,0,1,195,0,410,5,411
411,199,199,199,199,2,197,199,197,197,197,2,2,1,1,0,0,0,0,0,0,0,0,0,0,0,1,0,2,196,0,411,5,412
412,199,199,199,199,199,0,0,0,0,0,0,0,0,0,0,0,0,0,0,0,0,0,0,0,0,0,0,0,0,0,412,5,413
413,200,200,200,200,200,0,0,0,0,0,0,0,0,0,0,0,0,0,0,0,0,0,0,0,0,0,0,0,0,0,413,5,414
414,199,204,199,199,199,5,5,5,5,5,5,5,5,0,0,0,0,0,0,0,0,0,0,0,0,0,5,0,0,0,414,5,415
415,199,210,199,199,78,132,132,132,132,132,12,12,12,1,0,0,0,0,0,0,0,0,0,0,0,1,11,0,120,0,415,5,416
416,200,200,200,200,2,198,200,198,198,198,2,2,1,1,0,0,0,0,0,0,0,0,0,0,0,1,0,2,197,0,416,5,417
417,199,199,199,199,6,193,193,193,193,193,1,1,1,1,0,0,0,0,0,0,0,0,0,0,0,1,0,0,192,0,417,5,418
418,199,252,199,199,199,53,53,53,53,53,53,53,53,0,0,0,0,0,0,0,0,0,0,0,0,0,53,0,0,0,418,5,419
419,199,199,199,199,8,191,191,191,191,191,1,1,1,1,0,0,0,0,0,0,0,0,0,0,0,1,0,0,190,0,419,5,420
420,198,199,198,198,4,195,195,195,195,195,2,2,2,1,0,0,0,0,0,0,0,0,0,0,0,1,1,0,193,0,420,5,421
421,216,216,216,216,216,0,0,0,0,0,0,0,0,0,0,0,0,0,0,0,0,0,0,0,0,0,0,0,0,0,421,6,422
422,199,274,199,199,199,75,75,75,75,75,75,75,75,0,0,0,0,0,0,0,0,0,0,0,0,0,75,0,0,0,422,5,423
423,199,199,199,199,2,197,198,197,197,197,1,1,1,1,0,0,0,0,0,0,0,0,0,0,0,1,0,1,196,0,423,5,424
424,200,200,200,200,3,197,197,197,197,197,2,2,1,1,0,0,0,0,0,0,0,0,0,0,0,1,0,1,195,0,424,5,425
425,199,199,199,199,199,0,0,0,0,0,0,0,0,0,0,0,0,0,0,0,0,0,0,0,0,0,0,0,0,0,425,5,426
426,215,216,215,215,215,1,1,1,1,1,1,1,1,0,0,0,0,0,0,0,0,0,0,0,0,0,1,0,0,0,426,6,427
427,199,199,199,199,2,197,197,197,197,197,2,2,1,1,0,0,0,0,0,0,0,0,0,0,0,1,0,1,195,0,427,5,428
428,200,200,200,200,3,197,197,197,197,197,2,2,1,1,0,0,0,0,0,0,0,0,0,0,0,1,0,1,195,0,428,5,429
429,216,216,216,216,2,214,215,214,214,214,1,1,1,1,0,0,0,0,0,0,0,0,0,0,0,1,0,1,213,0,429,6,430
430,199,201,199,199,6,195,196,195,195,195,3,3,3,1,0,0,0,0,0,0,0,0,0,0,0,1,2,1,192,0,430,5,431
431,199,199,199,199,2,197,199,197,197,197,2,2,1,1,0,0,0,0,0,0,0,0,0,0,0,1,0,2,196,0,431,5,432
432,215,215,215,215,215,0,0,0,0,0,0,0,0,0,0,0,0,0,0,0,0,0,0,0,0,0,0,0,0,0,432,6,433
433,214,214,214,214,2,212,212,212,212,212,2,2,1,1,0,0,0,0,0,0,0,0,0,0,0,1,0,1,210,0,433,6,434
434,199,199,199,199,2,197,198,197,197,197,1,1,1,1,0,0,0,0,0,0,0,0,0,0,0,1,0,1,196,0,434,5,435
435,215,215,215,215,6,209,209,209,209,209,2,2,1,1,0,0,0,0,0,0,0,0,0,0,0,1,0,1,207,0,435,6,436
436,200,200,200,200,200,0,0,0,0,0,0,0,0,0,0,0,0,0,0,0,0,0,0,0,0,0,0,0,0,0,436,5,437
437,214,214,214,214,3,211,211,211,211,211,2,2,1,1,0,0,0,0,0,0,0,0,0,0,0,1,0,1,209,0,437,6,438
438,199,199,199,199,14,185,186,185,185,185,1,1,1,1,0,0,0,0,0,0,0,0,0,0,0,1,0,1,184,0,438,6,439
439,215,215,215,215,215,0,0,0,0,0,0,0,0,0,0,0,0,0,0,0,0,0,0,0,0,0,0,0,0,0,439,6,440
440,200,201,200,200,200,1,1,1,1,1,1,1,1,0,0,0,0,0,0,0,0,0,0,0,0,0,1,0,0,0,440,6,441
441,199,199,199,199,8,191,191,191,191,191,1,1,1,1,0,0,0,0,0,0,0,0,0,0,0,1,0,0,190,0,441,5,442
442,199,199,199,199,2,197,197,197,197,197,2,2,1,1,0,0,0,0,0,0,0,0,0,0,0,1,0,1,195,0,442,6,443
443,215,215,215,215,2,213,213,213,213,213,2,2,1,1,0,0,0,0,0,0,0,0,0,0,0,1,0,1,211,0,443,6,444
444,200,200,200,200,2,198,198,198,198,198,2,2,1,1,0,0,0,0,0,0,0,0,0,0,0,1,0,1,196,0,444,6,445
445,199,254,199,199,199,55,55,55,55,55,55,55,55,0,0,0,0,0,0,0,0,0,0,0,0,0,55,0,0,0,445,5,446
446,199,199,199,199,2,197,198,197,197,197,2,2,1,1,0,0,0,0,0,0,0,0,0,0,0,1,0,2,195,0,446,6,447
447,215,219,215,215,24,195,196,195,195,195,5,5,5,1,0,0,0,0,0,0,0,0,0,0,0,1,4,1,190,0,447,6,448
448,199,199,199,199,6,193,193,193,193,193,2,2,1,1,0,0,0,0,0,0,0,0,0,0,0,1,0,1,191,0,448,6,449
449,214,214,214,214,2,212,212,212,212,212,1,1,1,1,0,0,0,0,0,0,0,0,0,0,0,1,0,0,211,0,449,6,450
450,199,203,199,199,32,171,172,171,171,171,5,5,5,1,0,0,0,0,0,0,0,0,0,0,0,1,4,1,166,0,450,6,451
451,215,215,215,215,2,213,213,213,213,213,1,1,1,1,0,0,0,0,0,0,0,0,0,0,0,1,0,0,212,0,451,6,452
452,199,199,199,199,2,197,198,197,197,197,1,1,1,1,0,0,0,0,0,0,0,0,0,0,0,1,0,1,196,0,452,6,453
453,214,214,214,214,214,0,0,0,0,0,0,0,0,0,0,0,0,0,0,0,0,0,0,0,0,0,0,0,0,0,453,6,454
454,199,199,199,199,6,193,193,193,193,193,1,1,1,1,0,0,0,0,0,0,0,0,0,0,0,1,0,0,192,0,454,6,455
455,215,215,215,215,2,213,214,213,213,213,1,1,1,1,0,0,0,0,0,0,0,0,0,0,0,1,0,1,212,0,455,6,456
456,199,199,199,199,2,197,197,197,197,197,2,2,1,1,0,0,0,0,0,0,0,0,0,0,0,1,0,1,195,0,456,6,457
457,214,214,214,214,2,212,213,212,212,212,2,2,1,1,0,0,0,0,0,0,0,0,0,0,0,1,0,2,210,0,457,6,458
458,199,199,199,199,12,187,187,187,187,187,1,1,1,1,0,0,0,0,0,0,0,0,0,0,0,1,0,0,186,0,458,6,459
459,215,215,215,215,6,209,209,209,209,209,1,1,1,1,0,0,0,0,0,0,0,0,0,0,0,1,0,0,208,0,459,6,460
460,199,199,199,199,2,197,198,197,197,197,1,1,1,1,0,0,0,0,0,0,0,0,0,0,0,1,0,1,196,0,460,6,461
461,214,214,214,214,2,212,213,212,212,212,2,2,1,1,0,0,0,0,0,0,0,0,0,0,0,1,0,2,210,0,461,6,462
462,215,215,215,215,6,209,210,209,209,209,1,1,1,1,0,0,0,0,0,0,0,0,0,0,0,1,0,1,208,0,462,7,463
463,199,210,199,199,170,40,40,40,40,40,12,12,12,1,0,0,0,0,0,0,0,0,0,0,0,1,11,0,28,0,463,7,464
464,199,203,199,199,22,181,181,181,181,181,5,5,5,1,0,0,0,0,0,0,0,0,0,0,0,1,4,0,176,0,464,6,465
465,216,216,216,216,2,214,215,214,214,214,1,1,1,1,0,0,0,0,0,0,0,0,0,0,0,1,0,1,213,0,465,6,466
466,215,215,215,215,2,213,214,213,213,213,1,1,1,1,0,0,0,0,0,0,0,0,0,0,0,1,0,1,212,0,466,7,467
467,215,216,215,215,6,210,210,210,210,210,2,2,2,1,0,0,0,0,0,0,0,0,0,0,0,1,1,0,208,0,467,5,468
468,215,226,215,215,215,11,11,11,11,11,11,11,11,0,0,0,0,0,0,0,0,0,0,0,0,0,11,0,0,0,468,6,469
469,198,198,198,198,2,196,196,196,196,196,2,2,1,1,0,0,0,0,0,0,0,0,0,0,0,1,0,1,194,0,469,6,470
470,215,215,215,215,3,212,212,212,212,212,2,2,1,1,0,0,0,0,0,0,0,0,0,0,0,1,0,1,210,0,470,7,471
471,215,216,215,215,215,1,1,1,1,1,1,1,1,0,0,0,0,0,0,0,0,0,0,0,0,0,1,0,0,0,471,6,472
472,215,217,215,215,215,2,2,2,2,2,2,2,2,0,0,0,0,0,0,0,0,0,0,0,0,0,2,0,0,0,472,6,473
473,214,214,214,214,214,0,0,0,0,0,0,0,0,0,0,0,0,0,0,0,0,0,0,0,0,0,0,0,0,0,473,6,474
474,215,215,215,215,215,0,0,0,0,0,0,0,0,0,0,0,0,0,0,0,0,0,0,0,0,0,0,0,0,0,474,7,475
475,215,216,215,215,6,210,210,210,210,210,2,2,2,1,0,0,0,0,0,0,0,0,0,0,0,1,1,0,208,0,475,6,476
476,199,199,199,199,2,197,197,197,197,197,2,2,1,1,0,0,0,0,0,0,0,0,0,0,0,1,0,1,195,0,476,6,477
477,214,217,214,214,214,3,3,3,3,3,3,3,3,0,0,0,0,0,0,0,0,0,0,0,0,0,3,0,0,0,477,5,478
478,199,199,199,199,6,193,193,193,193,193,1,1,1,1,0,0,0,0,0,0,0,0,0,0,0,1,0,0,192,0,478,6,479
479,215,252,215,215,48,204,205,204,204,204,38,38,38,1,0,0,0,0,0,0,0,0,0,0,0,1,37,1,166,0,479,6,480
480,216,216,216,216,2,214,215,214,214,214,2,2,1,1,0,0,0,0,0,0,0,0,0,0,0,1,0,2,212,0,480,6,481
481,198,199,198,198,6,193,193,193,193,193,2,2,2,1,0,0,0,0,0,0,0,0,0,0,0,1,1,0,191,0,481,6,482
482,200,200,200,200,2,198,199,198,198,198,1,1,1,1,0,0,0,0,0,0,0,0,0,0,0,1,0,1,197,0,482,6,483
483,216,216,216,216,6,210,210,210,210,210,1,1,1,1,0,0,0,0,0,0,0,0,0,0,0,1,0,0,209,0,483,5,484
484,217,224,217,217,48,176,176,176,176,176,8,8,8,1,0,0,0,0,0,0,0,0,0,0,0,1,7,0,168,0,484,4,485
485,216,216,216,216,216,0,0,0,0,0,0,0,0,0,0,0,0,0,0,0,0,0,0,0,0,0,0,0,0,0,485,4,486
486,193,194,193,193,6,188,188,188,188,188,2,2,2,1,0,0,0,0,0,0,0,0,0,0,0,1,1,0,186,0,486,7,487
487,217,218,217,217,217,1,1,1,1,1,1,1,1,0,0,0,0,0,0,0,0,0,0,0,0,0,1,0,0,0,487,5,488
488,201,201,201,201,2,199,199,199,199,199,1,1,1,1,0,0,0,0,0,0,0,0,0,0,0,1,0,0,198,0,488,5,489
489,201,204,201,201,74,130,130,130,130,130,4,4,4,1,0,0,0,0,0,0,0,0,0,0,0,1,3,0,126,0,489,6,490
490,218,218,218,218,10,208,208,208,208,208,1,1,1,1,0,0,0,0,0,0,0,0,0,0,0,1,0,0,207,0,490,6,491
491,218,218,218,218,2,216,217,216,216,216,2,2,1,1,0,0,0,0,0,0,0,0,0,0,0,1,0,2,214,0,491,5,492
492,218,224,218,218,218,6,6,6,6,6,6,6,6,0,0,0,0,0,0,0,0,0,0,0,0,0,6,0,0,0,492,6,493
493,202,202,202,202,2,200,201,200,200,200,2,2,1,1,0,0,0,0,0,0,0,0,0,0,0,1,0,1,199,0,493,6,494
494,203,210,203,203,40,170,171,170,170,170,8,8,8,1,0,0,0,0,0,0,0,0,0,0,0,1,7,1,162,0,494,5,495
495,203,203,203,203,2,201,202,201,201,201,1,1,1,1,0,0,0,0,0,0,0,0,0,0,0,1,0,1,200,0,495,6,496
496,203,204,203,203,203,1,1,1,1,1,1,1,1,0,0,0,0,0,0,0,0,0,0,0,0,0,1,0,0,0,496,5,497
497,219,219,219,219,2,217,217,217,217,217,2,2,1,1,0,0,0,0,0,0,0,0,0,0,0,1,0,1,215,0,497,5,498
498,184,185,184,184,5,180,180,180,180,180,2,2,2,1,0,0,0,0,0,0,0,0,0,0,0,1,1,0,178,0,498,5,499
499,184,184,184,184,184,0,0,0,0,0,0,0,0,0,0,0,0,0,0,0,0,0,0,0,0,0,0,0,0,0,499,6,500
500,204,210,204,204,70,140,140,140,140,140,7,7,7,1,0,0,0,0,0,0,0,0,0,0,0,1,6,0,133,0,500,6,501
501,204,204,204,204,2,202,202,202,202,202,1,1,1,1,0,0,0,0,0,0,0,0,0,0,0,1,0,0,201,0,501,6,502
502,221,231,221,221,221,10,10,10,10,10,10,10,10,0,0,0,0,0,0,0,0,0,0,0,0,0,10,0,0,0,502,7,503
503,181,184,181,181,181,3,3,3,3,3,3,3,3,0,0,0,0,0,0,0,0,0,0,0,0,0,3,0,0,0,503,6,504
504,205,205,205,205,2,203,203,203,203,203,2,2,1,1,0,0,0,0,0,0,0,0,0,0,0,1,0,1,201,0,504,6,505
505,221,222,221,221,14,208,208,208,208,208,2,2,2,1,0,0,0,0,0,0,0,0,0,0,0,1,1,0,206,0,505,5,506
506,222,222,222,222,2,220,221,220,220,220,1,1,1,1,0,0,0,0,0,0,0,0,0,0,0,1,0,1,219,0,506,5,507
507,206,206,206,206,2,204,205,204,204,204,1,1,1,1,0,0,0,0,0,0,0,0,0,0,0,1,0,1,203,0,507,6,508
508,222,222,222,222,2,220,222,220,220,220,2,2,1,1,0,0,0,0,0,0,0,0,0,0,0,1,0,2,219,0,508,6,509
509,177,177,177,177,8,169,169,169,169,169,1,1,1,1,0,0,0,0,0,0,0,0,0,0,0,1,0,0,168,0,509,4,510
510,175,175,175,175,2,173,174,173,173,173,1,1,1,1,0,0,0,0,0,0,0,0,0,0,0,1,0,1,172,0,510,5,511
129
130
131
132
133
134
135
136
137
138
139
140
141
142
143
144
145
146
147
148
149
150
151
152
153
154
155
156
157
158
159
160
161
162
163
164
165
166
167
168
169
170
171
172
173
174
175
176
177
178
179
180
181
182
183
184
185
186
187
188
189
190
191
192
193
194
195
196
197
198
199
200
201
202
203
204
205
206
207
208
209
210
211
212
213
214
215
216
217
218
219
220
221
222
223
224
225
226
227
228
229
230
231
232
233
234
235
236
237
238
239
240
241
242
243
244
245
246
247
248
249
250
251
252
253
254
255
256
257
258
259
260
261
262
263
264
265
266
267
268
269
270
271
272
273
274
275
276
277
278
279
280
281
282
283
284
285
286
287
288
289
290
291
292
293
294
295
296
297
298
299
300
301
302
303
304
305
306
307
308
309
310
311
312
313
314
315
316
317
318
319
320
321
322
323
324
325
326
327
328
329
330
331
332
333
334
335
336
337
338
339
340
341
342
343
344
345
346
347
348
349
350
351
352
353
354
355
356
357
358
359
360
361
362
363
364
365
366
367
368
369
370
371
372
373
374
375
376
377
378
379
380
381
382
383
384
385
386
387
388
389
390
391
392
393
394
395
396
397
398
399
400
401
402
403
404
405
406
407
408
409
410
411
412
413
414
415
416
417
418
419
420
421
422
423
424
425
426
427
428
429
430
431
432
433
434
435
436
437
438
439
440
441
442
443
444
445
446
447
448
449
450
451
452
453
454
455
456
457
458
459
460
461
462
463
464
465
466
467
468
469
470
471
472
473
474
475
476
477
478
479
480
481
482
483
484
485
486
487
488
489
490
491
492
493
494
495
496
497
498
499
500
501
502
503
504
505
506
507
508
509
510
511
1,1,1,1,1,1,0,0,0,0,0,0,0,0,0,0,0,0,0,0,0,0,0,0,0,0,0,0,0,0,0,1,1,129
1,1,1,1,1,1,0,0,0,0,0,0,0,0,0,0,0,0,0,0,0,0,0,0,0,0,0,0,0,0,0,1,1,130
1,1,1,1,1,1,0,0,0,0,0,0,0,0,0,0,0,0,0,0,0,0,0,0,0,0,0,0,0,0,0,1,1,131
1,1,1,1,1,1,0,0,0,0,0,0,0,0,0,0,0,0,0,0,0,0,0,0,0,0,0,0,0,0,0,1,1,132
1,1,1,1,1,1,0,0,0,0,0,0,0,0,0,0,0,0,0,0,0,0,0,0,0,0,0,0,0,0,0,1,1,133
1,1,1,1,1,1,0,0,0,0,0,0,0,0,0,0,0,0,0,0,0,0,0,0,0,0,0,0,0,0,0,1,1,134
1,1,1,1,1,1,0,0,0,0,0,0,0,0,0,0,0,0,0,0,0,0,0,0,0,0,0,0,0,0,0,1,1,135
1,1,1,1,1,1,0,0,0,0,0,0,0,0,0,0,0,0,0,0,0,0,0,0,0,0,0,0,0,0,0,1,1,136
1,1,1,1,1,1,0,0,0,0,0,0,0,0,0,0,0,0,0,0,0,0,0,0,0,0,0,0,0,0,0,1,1,137
1,1,1,1,1,1,0,0,0,0,0,0,0,0,0,0,0,0,0,0,0,0,0,0,0,0,0,0,0,0,0,1,1,138
1,1,1,1,1,1,0,0,0,0,0,0,0,0,0,0,0,0,0,0,0,0,0,0,0,0,0,0,0,0,0,1,1,139
1,1,1,1,1,1,0,0,0,0,0,0,0,0,0,0,0,0,0,0,0,0,0,0,0,0,0,0,0,0,0,1,1,140
1,1,1,1,1,1,0,0,0,0,0,0,0,0,0,0,0,0,0,0,0,0,0,0,0,0,0,0,0,0,0,1,1,141
1,1,1,1,1,1,0,0,0,0,0,0,0,0,0,0,0,0,0,0,0,0,0,0,0,0,0,0,0,0,0,1,1,142
1,1,1,1,1,1,0,0,0,0,0,0,0,0,0,0,0,0,0,0,0,0,0,0,0,0,0,0,0,0,0,1,1,143
1,1,1,1,1,1,0,0,0,0,0,0,0,0,0,0,0,0,0,0,0,0,0,0,0,0,0,0,0,0,0,1,1,144
1,1,1,1,1,1,0,0,0,0,0,0,0,0,0,0,0,0,0,0,0,0,0,0,0,0,0,0,0,0,0,1,1,145
1,1,1,1,1,1,0,0,0,0,0,0,0,0,0,0,0,0,0,0,0,0,0,0,0,0,0,0,0,0,0,1,1,146
1,1,1,1,1,1,0,0,0,0,0,0,0,0,0,0,0,0,0,0,0,0,0,0,0,0,0,0,0,0,0,1,1,147
1,1,1,1,1,1,0,0,0,0,0,0,0,0,0,0,0,0,0,0,0,0,0,0,0,0,0,0,0,0,0,1,1,148
1,1,1,1,1,1,0,0,0,0,0,0,0,0,0,0,0,0,0,0,0,0,0,0,0,0,0,0,0,0,0,1,1,149
1,1,1,1,1,1,0,0,0,0,0,0,0,0,0,0,0,0,0,0,0,0,0,0,0,0,0,0,0,0,0,1,1,150
1,1,1,1,1,1,0,0,0,0,0,0,0,0,0,0,0,0,0,0,0,0,0,0,0,0,0,0,0,0,0,1,1,151
1,1,1,1,1,1,0,0,0,0,0,0,0,0,0,0,0,0,0,0,0,0,0,0,0,0,0,0,0,0,0,1,1,152
1,1,1,1,1,1,0,0,0,0,0,0,0,0,0,0,0,0,0,0,0,0,0,0,0,0,0,0,0,0,0,1,1,153
1,1,1,1,1,1,0,0,0,0,0,0,0,0,0,0,0,0,0,0,0,0,0,0,0,0,0,0,0,0,0,1,1,154
1,1,1,1,1,1,0,0,0,0,0,0,0,0,0,0,0,0,0,0,0,0,0,0,0,0,0,0,0,0,0,1,1,155
1,1,1,1,1,1,0,0,0,0,0,0,0,0,0,0,0,0,0,0,0,0,0,0,0,0,0,0,0,0,0,1,1,156
1,1,1,1,1,1,0,0,0,0,0,0,0,0,0,0,0,0,0,0,0,0,0,0,0,0,0,0,0,0,0,1,1,157
1,1,1,1,1,1,0,0,0,0,0,0,0,0,0,0,0,0,0,0,0,0,0,0,0,0,0,0,0,0,0,1,1,158
1,1,1,1,1,1,0,0,0,0,0,0,0,0,0,0,0,0,0,0,0,0,0,0,0,0,0,0,0,0,0,1,1,159
1,1,1,1,1,1,0,0,0,0,0,0,0,0,0,0,0,0,0,0,0,0,0,0,0,0,0,0,0,0,0,1,1,160
1,1,1,1,1,1,0,0,0,0,0,0,0,0,0,0,0,0,0,0,0,0,0,0,0,0,0,0,0,0,0,1,1,161
1,1,1,1,1,1,0,0,0,0,0,0,0,0,0,0,0,0,0,0,0,0,0,0,0,0,0,0,0,0,0,1,1,162
1,1,1,1,1,1,0,0,0,0,0,0,0,0,0,0,0,0,0,0,0,0,0,0,0,0,0,0,0,0,0,1,1,163
1,1,1,1,1,1,0,0,0,0,0,0,0,0,0,0,0,0,0,0,0,0,0,0,0,0,0,0,0,0,0,1,1,164
1,1,1,1,1,1,0,0,0,0,0,0,0,0,0,0,0,0,0,0,0,0,0,0,0,0,0,0,0,0,0,1,1,165
1,1,1,1,1,1,0,0,0,0,0,0,0,0,0,0,0,0,0,0,0,0,0,0,0,0,0,0,0,0,0,1,1,166
1,1,1,1,1,1,0,0,0,0,0,0,0,0,0,0,0,0,0,0,0,0,0,0,0,0,0,0,0,0,0,1,1,167
1,1,1,1,1,1,0,0,0,0,0,0,0,0,0,0,0,0,0,0,0,0,0,0,0,0,0,0,0,0,0,1,1,168
1,1,1,1,1,1,0,0,0,0,0,0,0,0,0,0,0,0,0,0,0,0,0,0,0,0,0,0,0,0,0,1,1,169
1,1,1,1,1,1,0,0,0,0,0,0,0,0,0,0,0,0,0,0,0,0,0,0,0,0,0,0,0,0,0,1,1,170
1,1,1,1,1,1,0,0,0,0,0,0,0,0,0,0,0,0,0,0,0,0,0,0,0,0,0,0,0,0,0,1,1,171
1,1,1,1,1,1,0,0,0,0,0,0,0,0,0,0,0,0,0,0,0,0,0,0,0,0,0,0,0,0,0,1,1,172
1,1,1,1,1,1,0,0,0,0,0,0,0,0,0,0,0,0,0,0,0,0,0,0,0,0,0,0,0,0,0,1,1,173
1,1,1,1,1,1,0,0,0,0,0,0,0,0,0,0,0,0,0,0,0,0,0,0,0,0,0,0,0,0,0,1,1,174
1,1,1,1,1,1,0,0,0,0,0,0,0,0,0,0,0,0,0,0,0,0,0,0,0,0,0,0,0,0,0,1,1,175
1,1,1,1,1,1,0,0,0,0,0,0,0,0,0,0,0,0,0,0,0,0,0,0,0,0,0,0,0,0,0,1,1,176
1,1,1,1,1,1,0,0,0,0,0,0,0,0,0,0,0,0,0,0,0,0,0,0,0,0,0,0,0,0,0,1,1,177
1,1,1,1,1,1,0,0,0,0,0,0,0,0,0,0,0,0,0,0,0,0,0,0,0,0,0,0,0,0,0,1,1,178
1,1,1,1,1,1,0,0,0,0,0,0,0,0,0,0,0,0,0,0,0,0,0,0,0,0,0,0,0,0,0,1,1,179
1,1,1,1,1,1,0,0,0,0,0,0,0,0,0,0,0,0,0,0,0,0,0,0,0,0,0,0,0,0,0,1,1,180
1,1,1,1,1,1,0,0,0,0,0,0,0,0,0,0,0,0,0,0,0,0,0,0,0,0,0,0,0,0,0,1,1,181
1,1,1,1,1,1,0,0,0,0,0,0,0,0,0,0,0,0,0,0,0,0,0,0,0,0,0,0,0,0,0,1,1,182
1,1,1,1,1,1,0,0,0,0,0,0,0,0,0,0,0,0,0,0,0,0,0,0,0,0,0,0,0,0,0,1,1,183
1,1,1,1,1,1,0,0,0,0,0,0,0,0,0,0,0,0,0,0,0,0,0,0,0,0,0,0,0,0,0,1,1,184
1,1,1,1,1,1,0,0,0,0,0,0,0,0,0,0,0,0,0,0,0,0,0,0,0,0,0,0,0,0,0,1,1,185
1,1,1,1,1,1,0,0,0,0,0,0,0,0,0,0,0,0,0,0,0,0,0,0,0,0,0,0,0,0,0,1,1,186
1,1,1,1,1,1,0,0,0,0,0,0,0,0,0,0,0,0,0,0,0,0,0,0,0,0,0,0,0,0,0,1,1,187
1,1,1,1,1,1,0,0,0,0,0,0,0,0,0,0,0,0,0,0,0,0,0,0,0,0,0,0,0,0,0,1,1,188
1,1,1,1,1,1,0,0,0,0,0,0,0,0,0,0,0,0,0,0,0,0,0,0,0,0,0,0,0,0,0,1,1,189
1,1,1,1,1,1,0,0,0,0,0,0,0,0,0,0,0,0,0,0,0,0,0,0,0,0,0,0,0,0,0,1,1,190
1,1,1,1,1,1,0,0,0,0,0,0,0,0,0,0,0,0,0,0,0,0,0,0,0,0,0,0,0,0,0,1,1,191
1,1,1,1,1,1,0,0,0,0,0,0,0,0,0,0,0,0,0,0,0,0,0,0,0,0,0,0,0,0,0,1,1,192
1,1,1,1,1,1,0,0,0,0,0,0,0,0,0,0,0,0,0,0,0,0,0,0,0,0,0,0,0,0,0,1,1,193
1,1,1,1,1,1,0,0,0,0,0,0,0,0,0,0,0,0,0,0,0,0,0,0,0,0,0,0,0,0,0,1,1,194
1,1,1,1,1,1,0,0,0,0,0,0,0,0,0,0,0,0,0,0,0,0,0,0,0,0,0,0,0,0,0,1,1,195
1,1,1,1,1,1,0,0,0,0,0,0,0,0,0,0,0,0,0,0,0,0,0,0,0,0,0,0,0,0,0,1,1,196
1,1,1,1,1,1,0,0,0,0,0,0,0,0,0,0,0,0,0,0,0,0,0,0,0,0,0,0,0,0,0,1,1,197
1,1,1,1,1,1,0,0,0,0,0,0,0,0,0,0,0,0,0,0,0,0,0,0,0,0,0,0,0,0,0,1,1,198
1,1,1,1,1,1,0,0,0,0,0,0,0,0,0,0,0,0,0,0,0,0,0,0,0,0,0,0,0,0,0,1,1,199
1,1,1,1,1,1,0,0,0,0,0,0,0,0,0,0,0,0,0,0,0,0,0,0,0,0,0,0,0,0,0,1,1,200
1,1,1,1,1,1,0,0,0,0,0,0,0,0,0,0,0,0,0,0,0,0,0,0,0,0,0,0,0,0,0,1,1,201
1,1,1,1,1,1,0,0,0,0,0,0,0,0,0,0,0,0,0,0,0,0,0,0,0,0,0,0,0,0,0,1,1,202
1,1,1,1,1,1,0,0,0,0,0,0,0,0,0,0,0,0,0,0,0,0,0,0,0,0,0,0,0,0,0,1,1,203
1,1,1,1,1,1,0,0,0,0,0,0,0,0,0,0,0,0,0,0,0,0,0,0,0,0,0,0,0,0,0,1,1,204
1,1,1,1,1,1,0,0,0,0,0,0,0,0,0,0,0,0,0,0,0,0,0,0,0,0,0,0,0,0,0,1,1,205
1,1,1,1,1,1,0,0,0,0,0,0,0,0,0,0,0,0,0,0,0,0,0,0,0,0,0,0,0,0,0,1,1,206
1,1,1,1,1,1,0,0,0,0,0,0,0,0,0,0,0,0,0,0,0,0,0,0,0,0,0,0,0,0,0,1,1,207
1,1,1,1,1,1,0,0,0,0,0,0,0,0,0,0,0,0,0,0,0,0,0,0,0,0,0,0,0,0,0,1,1,208
1,1,1,1,1,1,0,0,0,0,0,0,0,0,0,0,0,0,0,0,0,0,0,0,0,0,0,0,0,0,0,1,1,209
1,1,1,1,1,1,0,0,0,0,0,0,0,0,0,0,0,0,0,0,0,0,0,0,0,0,0,0,0,0,0,1,1,210
1,1,1,1,1,1,0,0,0,0,0,0,0,0,0,0,0,0,0,0,0,0,0,0,0,0,0,0,0,0,0,1,1,211
1,1,1,1,1,1,0,0,0,0,0,0,0,0,0,0,0,0,0,0,0,0,0,0,0,0,0,0,0,0,0,1,1,212
1,1,1,1,1,1,0,0,0,0,0,0,0,0,0,0,0,0,0,0,0,0,0,0,0,0,0,0,0,0,0,1,1,213
1,1,1,1,1,1,0,0,0,0,0,0,0,0,0,0,0,0,0,0,0,0,0,0,0,0,0,0,0,0,0,1,1,214
1,1,1,1,1,1,0,0,0,0,0,0,0,0,0,0,0,0,0,0,0,0,0,0,0,0,0,0,0,0,0,1,1,215
1,1,1,1,1,1,0,0,0,0,0,0,0,0,0,0,0,0,0,0,0,0,0,0,0,0,0,0,0,0,0,1,1,216
1,1,1,1,1,1,0,0,0,0,0,0,0,0,0,0,0,0,0,0,0,0,0,0,0,0,0,0,0,0,0,1,1,217
1,1,1,1,1,1,0,0,0,0,0,0,0,0,0,0,0,0,0,0,0,0,0,0,0,0,0,0,0,0,0,1,1,218
1,1,1,1,1,1,0,0,0,0,0,0,0,0,0,0,0,0,0,0,0,0,0,0,0,0,0,0,0,0,0,1,1,219
1,1,1,1,1,1,0,0,0,0,0,0,0,0,0,0,0,0,0,0,0,0,0,0,0,0,0,0,0,0,0,1,1,220
1,1,1,1,1,1,0,0,0,0,0,0,0,0,0,0,0,0,0,0,0,0,0,0,0,0,0,0,0,0,0,1,1,221
1,1,1,1,1,1,0,0,0,0,0,0,0,0,0,0,0,0,0,0,0,0,0,0,0,0,0,0,0,0,0,1,1,222
1,1,1,1,1,1,0,0,0,0,0,0,0,0,0,0,0,0,0,0,0,0,0,0,0,0,0,0,0,0,0,1,1,223
1,1,1,1,1,1,0,0,0,0,0,0,0,0,0,0,0,0,0,0,0,0,0,0,0,0,0,0,0,0,0,1,1,224
1,1,1,1,1,1,0,0,0,0,0,0,0,0,0,0,0,0,0,0,0,0,0,0,0,0,0,0,0,0,0,1,1,225
1,1,1,1,1,1,0,0,0,0,0,0,0,0,0,0,0,0,0,0,0,0,0,0,0,0,0,0,0,0,0,1,1,226
1,1,1,1,1,1,0,0,0,0,0,0,0,0,0,0,0,0,0,0,0,0,0,0,0,0,0,0,0,0,0,1,1,227
1,1,1,1,1,1,0,0,0,0,0,0,0,0,0,0,0,0,0,0,0,0,0,0,0,0,0,0,0,0,0,1,1,228
1,1,1,1,1,1,0,0,0,0,0,0,0,0,0,0,0,0,0,0,0,0,0,0,0,0,0,0,0,0,0,1,1,229
1,1,1,1,1,1,0,0,0,0,0,0,0,0,0,0,0,0,0,0,0,0,0,0,0,0,0,0,0,0,0,1,1,230
1,1,1,1,1,1,0,0,0,0,0,0,0,0,0,0,0,0,0,0,0,0,0,0,0,0,0,0,0,0,0,1,1,231
1,1,1,1,1,1,0,0,0,0,0,0,0,0,0,0,0,0,0,0,0,0,0,0,0,0,0,0,0,0,0,1,1,232
1,1,1,1,1,1,0,0,0,0,0,0,0,0,0,0,0,0,0,0,0,0,0,0,0,0,0,0,0,0,0,1,1,233
1,1,1,1,1,1,0,0,0,0,0,0,0,0,0,0,0,0,0,0,0,0,0,0,0,0,0,0,0,0,0,1,1,234
1,1,1,1,1,1,0,0,0,0,0,0,0,0,0,0,0,0,0,0,0,0,0,0,0,0,0,0,0,0,0,1,1,235
1,1,1,1,1,1,0,0,0,0,0,0,0,0,0,0,0,0,0,0,0,0,0,0,0,0,0,0,0,0,0,1,1,236
1,1,1,1,1,1,0,0,0,0,0,0,0,0,0,0,0,0,0,0,0,0,0,0,0,0,0,0,0,0,0,1,1,237
1,1,1,1,1,1,0,0,0,0,0,0,0,0,0,0,0,0,0,0,0,0,0,0,0,0,0,0,0,0,0,1,1,238
1,1,1,1,1,1,0,0,0,0,0,0,0,0,0,0,0,0,0,0,0,0,0,0,0,0,0,0,0,0,0,1,1,239
1,1,1,1,1,1,0,0,0,0,0,0,0,0,0,0,0,0,0,0,0,0,0,0,0,0,0,0,0,0,0,1,1,240
1,1,1,1,1,1,0,0,0,0,0,0,0,0,0,0,0,0,0,0,0,0,0,0,0,0,0,0,0,0,0,1,1,241
1,1,1,1,1,1,0,0,0,0,0,0,0,0,0,0,0,0,0,0,0,0,0,0,0,0,0,0,0,0,0,1,1,242
1,1,1,1,1,1,0,0,0,0,0,0,0,0,0,0,0,0,0,0,0,0,0,0,0,0,0,0,0,0,0,1,1,243
1,1,1,1,1,1,0,0,0,0,0,0,0,0,0,0,0,0,0,0,0,0,0,0,0,0,0,0,0,0,0,1,1,244
1,1,1,1,1,1,0,0,0,0,0,0,0,0,0,0,0,0,0,0,0,0,0,0,0,0,0,0,0,0,0,1,1,245
1,1,1,1,1,1,0,0,0,0,0,0,0,0,0,0,0,0,0,0,0,0,0,0,0,0,0,0,0,0,0,1,1,246
1,1,1,1,1,1,0,0,0,0,0,0,0,0,0,0,0,0,0,0,0,0,0,0,0,0,0,0,0,0,0,1,1,247
1,1,1,1,1,1,0,0,0,0,0,0,0,0,0,0,0,0,0,0,0,0,0,0,0,0,0,0,0,0,0,1,1,248
1,1,1,1,1,1,0,0,0,0,0,0,0,0,0,0,0,0,0,0,0,0,0,0,0,0,0,0,0,0,0,1,1,249
1,1,1,1,1,1,0,0,0,0,0,0,0,0,0,0,0,0,0,0,0,0,0,0,0,0,0,0,0,0,0,1,1,250
1,1,1,1,1,1,0,0,0,0,0,0,0,0,0,0,0,0,0,0,0,0,0,0,0,0,0,0,0,0,0,1,1,251
1,1,1,1,1,1,0,0,0,0,0,0,0,0,0,0,0,0,0,0,0,0,0,0,0,0,0,0,0,0,0,1,1,252
1,1,1,1,1,1,0,0,0,0,0,0,0,0,0,0,0,0,0,0,0,0,0,0,0,0,0,0,0,0,0,1,1,253
1,1,1,1,1,1,0,0,0,0,0,0,0,0,0,0,0,0,0,0,0,0,0,0,0,0,0,0,0,0,0,1,1,254
1,1,1,1,1,1,0,0,0,0,0,0,0,0,0,0,0,0,0,0,0,0,0,0,0,0,0,0,0,0,0,1,1,255
1,1,1,1,1,1,0,0,0,0,0,0,0,0,0,0,0,0,0,0,0,0,0,0,0,0,0,0,0,0,0,1,1,256
1,1,1,1,1,1,0,0,0,0,0,0,0,0,0,0,0,0,0,0,0,0,0,0,0,0,0,0,0,0,0,1,1,257
1,1,1,1,1,1,0,0,0,0,0,0,0,0,0,0,0,0,0,0,0,0,0,0,0,0,0,0,0,0,0,1,1,258
1,1,1,1,1,1,0,0,0,0,0,0,0,0,0,0,0,0,0,0,0,0,0,0,0,0,0,0,0,0,0,1,1,259
1,1,1,1,1,1,0,0,0,0,0,0,0,0,0,0,0,0,0,0,0,0,0,0,0,0,0,0,0,0,0,1,1,260
1,1,1,1,1,1,0,0,0,0,0,0,0,0,0,0,0,0,0,0,0,0,0,0,0,0,0,0,0,0,0,1,1,261
1,1,1,1,1,1,0,0,0,0,0,0,0,0,0,0,0,0,0,0,0,0,0,0,0,0,0,0,0,0,0,1,1,262
1,1,1,1,1,1,0,0,0,0,0,0,0,0,0,0,0,0,0,0,0,0,0,0,0,0,0,0,0,0,0,1,1,263
1,1,1,1,1,1,0,0,0,0,0,0,0,0,0,0,0,0,0,0,0,0,0,0,0,0,0,0,0,0,0,1,1,264
1,1,1,1,1,1,0,0,0,0,0,0,0,0,0,0,0,0,0,0,0,0,0,0,0,0,0,0,0,0,0,1,1,265
1,1,1,1,1,1,0,0,0,0,0,0,0,0,0,0,0,0,0,0,0,0,0,0,0,0,0,0,0,0,0,1,1,266
1,1,1,1,1,1,0,0,0,0,0,0,0,0,0,0,0,0,0,0,0,0,0,0,0,0,0,0,0,0,0,1,1,267
1,1,1,1,1,1,0,0,0,0,0,0,0,0,0,0,0,0,0,0,0,0,0,0,0,0,0,0,0,0,0,1,1,268
1,1,1,1,1,1,0,0,0,0,0,0,0,0,0,0,0,0,0,0,0,0,0,0,0,0,0,0,0,0,0,1,1,269
1,1,1,1,1,1,0,0,0,0,0,0,0,0,0,0,0,0,0,0,0,0,0,0,0,0,0,0,0,0,0,1,1,270
1,1,1,1,1,1,0,0,0,0,0,0,0,0,0,0,0,0,0,0,0,0,0,0,0,0,0,0,0,0,0,1,1,271
1,1,1,1,1,1,0,0,0,0,0,0,0,0,0,0,0,0,0,0,0,0,0,0,0,0,0,0,0,0,0,1,1,272
1,1,1,1,1,1,0,0,0,0,0,0,0,0,0,0,0,0,0,0,0,0,0,0,0,0,0,0,0,0,0,1,1,273
1,1,1,1,1,1,0,0,0,0,0,0,0,0,0,0,0,0,0,0,0,0,0,0,0,0,0,0,0,0,0,1,1,274
1,1,1,1,1,1,0,0,0,0,0,0,0,0,0,0,0,0,0,0,0,0,0,0,0,0,0,0,0,0,0,1,1,275
1,1,1,1,1,1,0,0,0,0,0,0,0,0,0,0,0,0,0,0,0,0,0,0,0,0,0,0,0,0,0,1,1,276
1,1,1,1,1,1,0,0,0,0,0,0,0,0,0,0,0,0,0,0,0,0,0,0,0,0,0,0,0,0,0,1,1,277
1,1,1,1,1,1,0,0,0,0,0,0,0,0,0,0,0,0,0,0,0,0,0,0,0,0,0,0,0,0,0,1,1,278
1,1,1,1,1,1,0,0,0,0,0,0,0,0,0,0,0,0,0,0,0,0,0,0,0,0,0,0,0,0,0,1,1,279
1,1,1,1,1,1,0,0,0,0,0,0,0,0,0,0,0,0,0,0,0,0,0,0,0,0,0,0,0,0,0,1,1,280
1,1,1,1,1,1,0,0,0,0,0,0,0,0,0,0,0,0,0,0,0,0,0,0,0,0,0,0,0,0,0,1,1,281
1,1,1,1,1,1,0,0,0,0,0,0,0,0,0,0,0,0,0,0,0,0,0,0,0,0,0,0,0,0,0,1,1,282
1,1,1,1,1,1,0,0,0,0,0,0,0,0,0,0,0,0,0,0,0,0,0,0,0,0,0,0,0,0,0,1,1,283
1,1,1,1,1,1,0,0,0,0,0,0,0,0,0,0,0,0,0,0,0,0,0,0,0,0,0,0,0,0,0,1,1,284
1,1,1,1,1,1,0,0,0,0,0,0,0,0,0,0,0,0,0,0,0,0,0,0,0,0,0,0,0,0,0,1,1,285
1,1,1,1,1,1,0,0,0,0,0,0,0,0,0,0,0,0,0,0,0,0,0,0,0,0,0,0,0,0,0,1,1,286
1,1,1,1,1,1,0,0,0,0,0,0,0,0,0,0,0,0,0,0,0,0,0,0,0,0,0,0,0,0,0,1,1,287
1,1,1,1,1,1,0,0,0,0,0,0,0,0,0,0,0,0,0,0,0,0,0,0,0,0,0,0,0,0,0,1,1,288
1,1,1,1,1,1,0,0,0,0,0,0,0,0,0,0,0,0,0,0,0,0,0,0,0,0,0,0,0,0,0,1,1,289
1,1,1,1,1,1,0,0,0,0,0,0,0,0,0,0,0,0,0,0,0,0,0,0,0,0,0,0,0,0,0,1,1,290
1,1,1,1,1,1,0,0,0,0,0,0,0,0,0,0,0,0,0,0,0,0,0,0,0,0,0,0,0,0,0,1,1,291
1,1,1,1,1,1,0,0,0,0,0,0,0,0,0,0,0,0,0,0,0,0,0,0,0,0,0,0,0,0,0,1,1,292
1,1,1,1,1,1,0,0,0,0,0,0,0,0,0,0,0,0,0,0,0,0,0,0,0,0,0,0,0,0,0,1,1,293
1,1,1,1,1,1,0,0,0,0,0,0,0,0,0,0,0,0,0,0,0,0,0,0,0,0,0,0,0,0,0,1,1,294
1,1,1,1,1,1,0,0,0,0,0,0,0,0,0,0,0,0,0,0,0,0,0,0,0,0,0,0,0,0,0,1,1,295
1,1,1,1,1,1,0,0,0,0,0,0,0,0,0,0,0,0,0,0,0,0,0,0,0,0,0,0,0,0,0,1,1,296
1,1,1,1,1,1,0,0,0,0,0,0,0,0,0,0,0,0,0,0,0,0,0,0,0,0,0,0,0,0,0,1,1,297
1,1,1,1,1,1,0,0,0,0,0,0,0,0,0,0,0,0,0,0,0,0,0,0,0,0,0,0,0,0,0,1,1,298
1,1,1,1,1,1,0,0,0,0,0,0,0,0,0,0,0,0,0,0,0,0,0,0,0,0,0,0,0,0,0,1,1,299
1,1,1,1,1,1,0,0,0,0,0,0,0,0,0,0,0,0,0,0,0,0,0,0,0,0,0,0,0,0,0,1,1,300
1,1,1,1,1,1,0,0,0,0,0,0,0,0,0,0,0,0,0,0,0,0,0,0,0,0,0,0,0,0,0,1,1,301
1,1,1,1,1,1,0,0,0,0,0,0,0,0,0,0,0,0,0,0,0,0,0,0,0,0,0,0,0,0,0,1,1,302
1,1,1,1,1,1,0,0,0,0,0,0,0,0,0,0,0,0,0,0,0,0,0,0,0,0,0,0,0,0,0,1,1,303
1,1,1,1,1,1,0,0,0,0,0,0,0,0,0,0,0,0,0,0,0,0,0,0,0,0,0,0,0,0,0,1,1,304
1,1,1,1,1,1,0,0,0,0,0,0,0,0,0,0,0,0,0,0,0,0,0,0,0,0,0,0,0,0,0,1,1,305
1,1,1,1,1,1,0,0,0,0,0,0,0,0,0,0,0,0,0,0,0,0,0,0,0,0,0,0,0,0,0,1,1,306
1,1,1,1,1,1,0,0,0,0,0,0,0,0,0,0,0,0,0,0,0,0,0,0,0,0,0,0,0,0,0,1,1,307
1,1,1,1,1,1,0,0,0,0,0,0,0,0,0,0,0,0,0,0,0,0,0,0,0,0,0,0,0,0,0,1,1,308
1,1,1,1,1,1,0,0,0,0,0,0,0,0,0,0,0,0,0,0,0,0,0,0,0,0,0,0,0,0,0,1,1,309
1,1,1,1,1,1,0,0,0,0,0,0,0,0,0,0,0,0,0,0,0,0,0,0,0,0,0,0,0,0,0,1,1,310
1,1,1,1,1,1,0,0,0,0,0,0,0,0,0,0,0,0,0,0,0,0,0,0,0,0,0,0,0,0,0,1,1,311
1,1,1,1,1,1,0,0,0,0,0,0,0,0,0,0,0,0,0,0,0,0,0,0,0,0,0,0,0,0,0,1,1,312
1,1,1,1,1,1,0,0,0,0,0,0,0,0,0,0,0,0,0,0,0,0,0,0,0,0,0,0,0,0,0,1,1,313
1,1,1,1,1,1,0,0,0,0,0,0,0,0,0,0,0,0,0,0,0,0,0,0,0,0,0,0,0,0,0,1,1,314
1,1,1,1,1,1,0,0,0,0,0,0,0,0,0,0,0,0,0,0,0,0,0,0,0,0,0,0,0,0,0,1,1,315
1,1,1,1,1,1,0,0,0,0,0,0,0,0,0,0,0,0,0,0,0,0,0,0,0,0,0,0,0,0,0,1,1,316
1,1,1,1,1,1,0,0,0,0,0,0,0,0,0,0,0,0,0,0,0,0,0,0,0,0,0,0,0,0,0,1,1,317
1,1,1,1,1,1,0,0,0,0,0,0,0,0,0,0,0,0,0,0,0,0,0,0,0,0,0,0,0,0,0,1,1,318
1,1,1,1,1,1,0,0,0,0,0,0,0,0,0,0,0,0,0,0,0,0,0,0,0,0,0,0,0,0,0,1,1,319
1,1,1,1,1,1,0,0,0,0,0,0,0,0,0,0,0,0,0,0,0,0,0,0,0,0,0,0,0,0,0,1,1,320
1,1,1,1,1,1,0,0,0,0,0,0,0,0,0,0,0,0,0,0,0,0,0,0,0,0,0,0,0,0,0,1,1,321
1,1,1,1,1,1,0,0,0,0,0,0,0,0,0,0,0,0,0,0,0,0,0,0,0,0,0,0,0,0,0,1,1,322
1,1,1,1,1,1,0,0,0,0,0,0,0,0,0,0,0,0,0,0,0,0,0,0,0,0,0,0,0,0,0,1,1,323
1,1,1,1,1,1,0,0,0,0,0,0,0,0,0,0,0,0,0,0,0,0,0,0,0,0,0,0,0,0,0,1,1,324
1,1,1,1,1,1,0,0,0,0,0,0,0,0,0,0,0,0,0,0,0,0,0,0,0,0,0,0,0,0,0,1,1,325
1,1,1,1,1,1,0,0,0,0,0,0,0,0,0,0,0,0,0,0,0,0,0,0,0,0,0,0,0,0,0,1,1,326
1,1,1,1,1,1,0,0,0,0,0,0,0,0,0,0,0,0,0,0,0,0,0,0,0,0,0,0,0,0,0,1,1,327
1,1,1,1,1,1,0,0,0,0,0,0,0,0,0,0,0,0,0,0,0,0,0,0,0,0,0,0,0,0,0,1,1,328
1,1,1,1,1,1,0,0,0,0,0,0,0,0,0,0,0,0,0,0,0,0,0,0,0,0,0,0,0,0,0,1,1,329
1,1,1,1,1,1,0,0,0,0,0,0,0,0,0,0,0,0,0,0,0,0,0,0,0,0,0,0,0,0,0,1,1,330
1,1,1,1,1,1,0,0,0,0,0,0,0,0,0,0,0,0,0,0,0,0,0,0,0,0,0,0,0,0,0,1,1,331
1,1,1,1,1,1,0,0,0,0,0,0,0,0,0,0,0,0,0,0,0,0,0,0,0,0,0,0,0,0,0,1,1,332
1,1,1,1,1,1,0,0,0,0,0,0,0,0,0,0,0,0,0,0,0,0,0,0,0,0,0,0,0,0,0,1,1,333
1,1,1,1,1,1,0,0,0,0,0,0,0,0,0,0,0,0,0,0,0,0,0,0,0,0,0,0,0,0,0,1,1,334
1,1,1,1,1,1,0,0,0,0,0,0,0,0,0,0,0,0,0,0,0,0,0,0,0,0,0,0,0,0,0,1,1,335
1,1,1,1,1,1,0,0,0,0,0,0,0,0,0,0,0,0,0,0,0,0,0,0,0,0,0,0,0,0,0,1,1,336
1,1,1,1,1,1,0,0,0,0,0,0,0,0,0,0,0,0,0,0,0,0,0,0,0,0,0,0,0,0,0,1,1,337
1,1,1,1,1,1,0,0,0,0,0,0,0,0,0,0,0,0,0,0,0,0,0,0,0,0,0,0,0,0,0,1,1,338
1,1,1,1,1,1,0,0,0,0,0,0,0,0,0,0,0,0,0,0,0,0,0,0,0,0,0,0,0,0,0,1,1,339
1,1,1,1,1,1,0,0,0,0,0,0,0,0,0,0,0,0,0,0,0,0,0,0,0,0,0,0,0,0,0,1,1,340
1,1,1,1,1,1,0,0,0,0,0,0,0,0,0,0,0,0,0,0,0,0,0,0,0,0,0,0,0,0,0,1,1,341
1,1,1,1,1,1,0,0,0,0,0,0,0,0,0,0,0,0,0,0,0,0,0,0,0,0,0,0,0,0,0,1,1,342
1,1,1,1,1,1,0,0,0,0,0,0,0,0,0,0,0,0,0,0,0,0,0,0,0,0,0,0,0,0,0,1,1,343
1,1,1,1,1,1,0,0,0,0,0,0,0,0,0,0,0,0,0,0,0,0,0,0,0,0,0,0,0,0,0,1,1,344
1,1,1,1,1,1,0,0,0,0,0,0,0,0,0,0,0,0,0,0,0,0,0,0,0,0,0,0,0,0,0,1,1,345
1,1,1,1,1,1,0,0,0,0,0,0,0,0,0,0,0,0,0,0,0,0,0,0,0,0,0,0,0,0,0,1,1,346
1,1,1,1,1,1,0,0,0,0,0,0,0,0,0,0,0,0,0,0,0,0,0,0,0,0,0,0,0,0,0,1,1,347
1,1,1,1,1,1,0,0,0,0,0,0,0,0,0,0,0,0,0,0,0,0,0,0,0,0,0,0,0,0,0,1,1,348
1,1,1,1,1,1,0,0,0,0,0,0,0,0,0,0,0,0,0,0,0,0,0,0,0,0,0,0,0,0,0,1,1,349
1,1,1,1,1,1,0,0,0,0,0,0,0,0,0,0,0,0,0,0,0,0,0,0,0,0,0,0,0,0,0,1,1,350
1,1,1,1,1,1,0,0,0,0,0,0,0,0,0,0,0,0,0,0,0,0,0,0,0,0,0,0,0,0,0,1,1,351
1,1,1,1,1,1,0,0,0,0,0,0,0,0,0,0,0,0,0,0,0,0,0,0,0,0,0,0,0,0,0,1,1,352
1,1,1,1,1,1,0,0,0,0,0,0,0,0,0,0,0,0,0,0,0,0,0,0,0,0,0,0,0,0,0,1,1,353
1,1,1,1,1,1,0,0,0,0,0,0,0,0,0,0,0,0,0,0,0,0,0,0,0,0,0,0,0,0,0,1,1,354
1,1,1,1,1,1,0,0,0,0,0,0,0,0,0,0,0,0,0,0,0,0,0,0,0,0,0,0,0,0,0,1,1,355
1,1,1,1,1,1,0,0,0,0,0,0,0,0,0,0,0,0,0,0,0,0,0,0,0,0,0,0,0,0,0,1,1,356
1,1,1,1,1,1,0,0,0,0,0,0,0,0,0,0,0,0,0,0,0,0,0,0,0,0,0,0,0,0,0,1,1,357
1,1,1,1,1,1,0,0,0,0,0,0,0,0,0,0,0,0,0,0,0,0,0,0,0,0,0,0,0,0,0,1,1,358
1,1,1,1,1,1,0,0,0,0,0,0,0,0,0,0,0,0,0,0,0,0,0,0,0,0,0,0,0,0,0,1,1,359
1,1,1,1,1,1,0,0,0,0,0,0,0,0,0,0,0,0,0,0,0,0,0,0,0,0,0,0,0,0,0,1,1,360
1,1,1,1,1,1,0,0,0,0,0,0,0,0,0,0,0,0,0,0,0,0,0,0,0,0,0,0,0,0,0,1,1,361
1,1,1,1,1,1,0,0,0,0,0,0,0,0,0,0,0,0,0,0,0,0,0,0,0,0,0,0,0,0,0,1,1,362
1,1,1,1,1,1,0,0,0,0,0,0,0,0,0,0,0,0,0,0,0,0,0,0,0,0,0,0,0,0,0,1,1,363
1,1,1,1,1,1,0,0,0,0,0,0,0,0,0,0,0,0,0,0,0,0,0,0,0,0,0,0,0,0,0,1,1,364
1,1,1,1,1,1,0,0,0,0,0,0,0,0,0,0,0,0,0,0,0,0,0,0,0,0,0,0,0,0,0,1,1,365
1,1,1,1,1,1,0,0,0,0,0,0,0,0,0,0,0,0,0,0,0,0,0,0,0,0,0,0,0,0,0,1,1,366
1,1,1,1,1,1,0,0,0,0,0,0,0,0,0,0,0,0,0,0,0,0,0,0,0,0,0,0,0,0,0,1,1,367
1,1,1,1,1,1,0,0,0,0,0,0,0,0,0,0,0,0,0,0,0,0,0,0,0,0,0,0,0,0,0,1,1,368
1,1,1,1,1,1,0,0,0,0,0,0,0,0,0,0,0,0,0,0,0,0,0,0,0,0,0,0,0,0,0,1,1,369
1,1,1,1,1,1,0,0,0,0,0,0,0,0,0,0,0,0,0,0,0,0,0,0,0,0,0,0,0,0,0,1,1,370
1,1,1,1,1,1,0,0,0,0,0,0,0,0,0,0,0,0,0,0,0,0,0,0,0,0,0,0,0,0,0,1,1,371
1,1,1,1,1,1,0,0,0,0,0,0,0,0,0,0,0,0,0,0,0,0,0,0,0,0,0,0,0,0,0,1,1,372
1,1,1,1,1,1,0,0,0,0,0,0,0,0,0,0,0,0,0,0,0,0,0,0,0,0,0,0,0,0,0,1,1,373
1,1,1,1,1,1,0,0,0,0,0,0,0,0,0,0,0,0,0,0,0,0,0,0,0,0,0,0,0,0,0,1,1,374
1,1,1,1,1,1,0,0,0,0,0,0,0,0,0,0,0,0,0,0,0,0,0,0,0,0,0,0,0,0,0,1,1,375
1,1,1,1,1,1,0,0,0,0,0,0,0,0,0,0,0,0,0,0,0,0,0,0,0,0,0,0,0,0,0,1,1,376
1,1,1,1,1,1,0,0,0,0,0,0,0,0,0,0,0,0,0,0,0,0,0,0,0,0,0,0,0,0,0,1,1,377
1,1,1,1,1,1,0,0,0,0,0,0,0,0,0,0,0,0,0,0,0,0,0,0,0,0,0,0,0,0,0,1,1,378
1,1,1,1,1,1,0,0,0,0,0,0,0,0,0,0,0,0,0,0,0,0,0,0,0,0,0,0,0,0,0,1,1,379
1,1,1,1,1,1,0,0,0,0,0,0,0,0,0,0,0,0,0,0,0,0,0,0,0,0,0,0,0,0,0,1,1,380
1,1,1,1,1,1,0,0,0,0,0,0,0,0,0,0,0,0,0,0,0,0,0,0,0,0,0,0,0,0,0,1,1,381
1,1,1,1,1,1,0,0,0,0,0,0,0,0,0,0,0,0,0,0,0,0,0,0,0,0,0,0,0,0,0,1,1,382
1,1,1,1,1,1,0,0,0,0,0,0,0,0,0,0,0,0,0,0,0,0,0,0,0,0,0,0,0,0,0,1,1,383
1,1,1,1,1,1,0,0,0,0,0,0,0,0,0,0,0,0,0,0,0,0,0,0,0,0,0,0,0,0,0,1,1,384
1,1,1,1,1,1,0,0,0,0,0,0,0,0,0,0,0,0,0,0,0,0,0,0,0,0,0,0,0,0,0,1,1,385
1,1,1,1,1,1,0,0,0,0,0,0,0,0,0,0,0,0,0,0,0,0,0,0,0,0,0,0,0,0,0,1,1,386
1,1,1,1,1,1,0,0,0,0,0,0,0,0,0,0,0,0,0,0,0,0,0,0,0,0,0,0,0,0,0,1,1,387
1,1,1,1,1,1,0,0,0,0,0,0,0,0,0,0,0,0,0,0,0,0,0,0,0,0,0,0,0,0,0,1,1,388
1,1,1,1,1,1,0,0,0,0,0,0,0,0,0,0,0,0,0,0,0,0,0,0,0,0,0,0,0,0,0,1,1,389
1,1,1,1,1,1,0,0,0,0,0,0,0,0,0,0,0,0,0,0,0,0,0,0,0,0,0,0,0,0,0,1,1,390
1,1,1,1,1,1,0,0,0,0,0,0,0,0,0,0,0,0,0,0,0,0,0,0,0,0,0,0,0,0,0,1,1,391
1,1,1,1,1,1,0,0,0,0,0,0,0,0,0,0,0,0,0,0,0,0,0,0,0,0,0,0,0,0,0,1,1,392
1,1,1,1,1,1,0,0,0,0,0,0,0,0,0,0,0,0,0,0,0,0,0,0,0,0,0,0,0,0,0,1,1,393
1,1,1,1,1,1,0,0,0,0,0,0,0,0,0,0,0,0,0,0,0,0,0,0,0,0,0,0,0,0,0,1,1,394
1,1,1,1,1,1,0,0,0,0,0,0,0,0,0,0,0,0,0,0,0,0,0,0,0,0,0,0,0,0,0,1,1,395
1,1,1,1,1,1,0,0,0,0,0,0,0,0,0,0,0,0,0,0,0,0,0,0,0,0,0,0,0,0,0,1,1,396
1,1,1,1,1,1,0,0,0,0,0,0,0,0,0,0,0,0,0,0,0,0,0,0,0,0,0,0,0,0,0,1,1,397
1,1,1,1,1,1,0,0,0,0,0,0,0,0,0,0,0,0,0,0,0,0,0,0,0,0,0,0,0,0,0,1,1,398
1,1,1,1,1,1,0,0,0,0,0,0,0,0,0,0,0,0,0,0,0,0,0,0,0,0,0,0,0,0,0,1,1,399
1,1,1,1,1,1,0,0,0,0,0,0,0,0,0,0,0,0,0,0,0,0,0,0,0,0,0,0,0,0,0,1,1,400
1,1,1,1,1,1,0,0,0,0,0,0,0,0,0,0,0,0,0,0,0,0,0,0,0,0,0,0,0,0,0,1,1,401
1,1,1,1,1,1,0,0,0,0,0,0,0,0,0,0,0,0,0,0,0,0,0,0,0,0,0,0,0,0,0,1,1,402
1,1,1,1,1,1,0,0,0,0,0,0,0,0,0,0,0,0,0,0,0,0,0,0,0,0,0,0,0,0,0,1,1,403
1,1,1,1,1,1,0,0,0,0,0,0,0,0,0,0,0,0,0,0,0,0,0,0,0,0,0,0,0,0,0,1,1,404
1,1,1,1,1,1,0,0,0,0,0,0,0,0,0,0,0,0,0,0,0,0,0,0,0,0,0,0,0,0,0,1,1,405
1,1,1,1,1,1,0,0,0,0,0,0,0,0,0,0,0,0,0,0,0,0,0,0,0,0,0,0,0,0,0,1,1,406
1,1,1,1,1,1,0,0,0,0,0,0,0,0,0,0,0,0,0,0,0,0,0,0,0,0,0,0,0,0,0,1,1,407
1,1,1,1,1,1,0,0,0,0,0,0,0,0,0,0,0,0,0,0,0,0,0,0,0,0,0,0,0,0,0,1,1,408
1,1,1,1,1,1,0,0,0,0,0,0,0,0,0,0,0,0,0,0,0,0,0,0,0,0,0,0,0,0,0,1,1,409
1,1,1,1,1,1,0,0,0,0,0,0,0,0,0,0,0,0,0,0,0,0,0,0,0,0,0,0,0,0,0,1,1,410
1,1,1,1,1,1,0,0,0,0,0,0,0,0,0,0,0,0,0,0,0,0,0,0,0,0,0,0,0,0,0,1,1,411
1,1,1,1,1,1,0,0,0,0,0,0,0,0,0,0,0,0,0,0,0,0,0,0,0,0,0,0,0,0,0,1,1,412
1,1,1,1,1,1,0,0,0,0,0,0,0,0,0,0,0,0,0,0,0,0,0,0,0,0,0,0,0,0,0,1,1,413
1,1,1,1,1,1,0,0,0,0,0,0,0,0,0,0,0,0,0,0,0,0,0,0,0,0,0,0,0,0,0,1,1,414
1,1,1,1,1,1,0,0,0,0,0,0,0,0,0,0,0,0,0,0,0,0,0,0,0,0,0,0,0,0,0,1,1,415
1,1,1,1,1,1,0,0,0,0,0,0,0,0,0,0,0,0,0,0,0,0,0,0,0,0,0,0,0,0,0,1,1,416
1,1,1,1,1,1,0,0,0,0,0,0,0,0,0,0,0,0,0,0,0,0,0,0,0,0,0,0,0,0,0,1,1,417
1,1,1,1,1,1,0,0,0,0,0,0,0,0,0,0,0,0,0,0,0,0,0,0,0,0,0,0,0,0,0,1,1,418
1,1,1,1,1,1,0,0,0,0,0,0,0,0,0,0,0,0,0,0,0,0,0,0,0,0,0,0,0,0,0,1,1,419
1,1,1,1,1,1,0,0,0,0,0,0,0,0,0,0,0,0,0,0,0,0,0,0,0,0,0,0,0,0,0,1,1,420
1,1,1,1,1,1,0,0,0,0,0,0,0,0,0,0,0,0,0,0,0,0,0,0,0,0,0,0,0,0,0,1,1,421
1,1,1,1,1,1,0,0,0,0,0,0,0,0,0,0,0,0,0,0,0,0,0,0,0,0,0,0,0,0,0,1,1,422
1,1,1,1,1,1,0,0,0,0,0,0,0,0,0,0,0,0,0,0,0,0,0,0,0,0,0,0,0,0,0,1,1,423
1,1,1,1,1,1,0,0,0,0,0,0,0,0,0,0,0,0,0,0,0,0,0,0,0,0,0,0,0,0,0,1,1,424
1,1,1,1,1,1,0,0,0,0,0,0,0,0,0,0,0,0,0,0,0,0,0,0,0,0,0,0,0,0,0,1,1,425
1,1,1,1,1,1,0,0,0,0,0,0,0,0,0,0,0,0,0,0,0,0,0,0,0,0,0,0,0,0,0,1,1,426
1,1,1,1,1,1,0,0,0,0,0,0,0,0,0,0,0,0,0,0,0,0,0,0,0,0,0,0,0,0,0,1,1,427
1,1,1,1,1,1,0,0,0,0,0,0,0,0,0,0,0,0,0,0,0,0,0,0,0,0,0,0,0,0,0,1,1,428
1,1,1,1,1,1,0,0,0,0,0,0,0,0,0,0,0,0,0,0,0,0,0,0,0,0,0,0,0,0,0,1,1,429
1,1,1,1,1,1,0,0,0,0,0,0,0,0,0,0,0,0,0,0,0,0,0,0,0,0,0,0,0,0,0,1,1,430
1,1,1,1,1,1,0,0,0,0,0,0,0,0,0,0,0,0,0,0,0,0,0,0,0,0,0,0,0,0,0,1,1,431
1,1,1,1,1,1,0,0,0,0,0,0,0,0,0,0,0,0,0,0,0,0,0,0,0,0,0,0,0,0,0,1,1,432
1,1,1,1,1,1,0,0,0,0,0,0,0,0,0,0,0,0,0,0,0,0,0,0,0,0,0,0,0,0,0,1,1,433
1,1,1,1,1,1,0,0,0,0,0,0,0,0,0,0,0,0,0,0,0,0,0,0,0,0,0,0,0,0,0,1,1,434
1,1,1,1,1,1,0,0,0,0,0,0,0,0,0,0,0,0,0,0,0,0,0,0,0,0,0,0,0,0,0,1,1,435
1,1,1,1,1,1,0,0,0,0,0,0,0,0,0,0,0,0,0,0,0,0,0,0,0,0,0,0,0,0,0,1,1,436
1,1,1,1,1,1,0,0,0,0,0,0,0,0,0,0,0,0,0,0,0,0,0,0,0,0,0,0,0,0,0,1,1,437
1,1,1,1,1,1,0,0,0,0,0,0,0,0,0,0,0,0,0,0,0,0,0,0,0,0,0,0,0,0,0,1,1,438
1,1,1,1,1,1,0,0,0,0,0,0,0,0,0,0,0,0,0,0,0,0,0,0,0,0,0,0,0,0,0,1,1,439
1,1,1,1,1,1,0,0,0,0,0,0,0,0,0,0,0,0,0,0,0,0,0,0,0,0,0,0,0,0,0,1,1,440
1,1,1,1,1,1,0,0,0,0,0,0,0,0,0,0,0,0,0,0,0,0,0,0,0,0,0,0,0,0,0,1,1,441
1,1,1,1,1,1,0,0,0,0,0,0,0,0,0,0,0,0,0,0,0,0,0,0,0,0,0,0,0,0,0,1,1,442
1,1,1,1,1,1,0,0,0,0,0,0,0,0,0,0,0,0,0,0,0,0,0,0,0,0,0,0,0,0,0,1,1,443
1,1,1,1,1,1,0,0,0,0,0,0,0,0,0,0,0,0,0,0,0,0,0,0,0,0,0,0,0,0,0,1,1,444
1,1,1,1,1,1,0,0,0,0,0,0,0,0,0,0,0,0,0,0,0,0,0,0,0,0,0,0,0,0,0,1,1,445
1,1,1,1,1,1,0,0,0,0,0,0,0,0,0,0,0,0,0,0,0,0,0,0,0,0,0,0,0,0,0,1,1,446
1,1,1,1,1,1,0,0,0,0,0,0,0,0,0,0,0,0,0,0,0,0,0,0,0,0,0,0,0,0,0,1,1,447
1,1,1,1,1,1,0,0,0,0,0,0,0,0,0,0,0,0,0,0,0,0,0,0,0,0,0,0,0,0,0,1,1,448
1,1,1,1,1,1,0,0,0,0,0,0,0,0,0,0,0,0,0,0,0,0,0,0,0,0,0,0,0,0,0,1,1,449
1,1,1,1,1,1,0,0,0,0,0,0,0,0,0,0,0,0,0,0,0,0,0,0,0,0,0,0,0,0,0,1,1,450
1,1,1,1,1,1,0,0,0,0,0,0,0,0,0,0,0,0,0,0,0,0,0,0,0,0,0,0,0,0,0,1,1,451
1,1,1,1,1,1,0,0,0,0,0,0,0,0,0,0,0,0,0,0,0,0,0,0,0,0,0,0,0,0,0,1,1,452
1,1,1,1,1,1,0,0,0,0,0,0,0,0,0,0,0,0,0,0,0,0,0,0,0,0,0,0,0,0,0,1,1,453
1,1,1,1,1,1,0,0,0,0,0,0,0,0,0,0,0,0,0,0,0,0,0,0,0,0,0,0,0,0,0,1,1,454
1,1,1,1,1,1,0,0,0,0,0,0,0,0,0,0,0,0,0,0,0,0,0,0,0,0,0,0,0,0,0,1,1,455
1,1,1,1,1,1,0,0,0,0,0,0,0,0,0,0,0,0,0,0,0,0,0,0,0,0,0,0,0,0,0,1,1,456
1,1,1,1,1,1,0,0,0,0,0,0,0,0,0,0,0,0,0,0,0,0,0,0,0,0,0,0,0,0,0,1,1,457
1,1,1,1,1,1,0,0,0,0,0,0,0,0,0,0,0,0,0,0,0,0,0,0,0,0,0,0,0,0,0,1,1,458
1,1,1,1,1,1,0,0,0,0,0,0,0,0,0,0,0,0,0,0,0,0,0,0,0,0,0,0,0,0,0,1,1,459
1,1,1,1,1,1,0,0,0,0,0,0,0,0,0,0,0,0,0,0,0,0,0,0,0,0,0,0,0,0,0,1,1,460
1,1,1,1,1,1,0,0,0,0,0,0,0,0,0,0,0,0,0,0,0,0,0,0,0,0,0,0,0,0,0,1,1,461
1,1,1,1,1,1,0,0,0,0,0,0,0,0,0,0,0,0,0,0,0,0,0,0,0,0,0,0,0,0,0,1,1,462
1,1,1,1,1,1,0,0,0,0,0,0,0,0,0,0,0,0,0,0,0,0,0,0,0,0,0,0,0,0,0,1,1,463
1,1,1,1,1,1,0,0,0,0,0,0,0,0,0,0,0,0,0,0,0,0,0,0,0,0,0,0,0,0,0,1,1,464
1,1,1,1,1,1,0,0,0,0,0,0,0,0,0,0,0,0,0,0,0,0,0,0,0,0,0,0,0,0,0,1,1,465
1,1,1,1,1,1,0,0,0,0,0,0,0,0,0,0,0,0,0,0,0,0,0,0,0,0,0,0,0,0,0,1,1,466
1,1,1,1,1,1,0,0,0,0,0,0,0,0,0,0,0,0,0,0,0,0,0,0,0,0,0,0,0,0,0,1,1,467
1,1,1,1,1,1,0,0,0,0,0,0,0,0,0,0,0,0,0,0,0,0,0,0,0,0,0,0,0,0,0,1,1,468
1,1,1,1,1,1,0,0,0,0,0,0,0,0,0,0,0,0,0,0,0,0,0,0,0,0,0,0,0,0,0,1,1,469
1,1,1,1,1,1,0,0,0,0,0,0,0,0,0,0,0,0,0,0,0,0,0,0,0,0,0,0,0,0,0,1,1,470
1,1,1,1,1,1,0,0,0,0,0,0,0,0,0,0,0,0,0,0,0,0,0,0,0,0,0,0,0,0,0,1,1,471
1,1,1,1,1,1,0,0,0,0,0,0,0,0,0,0,0,0,0,0,0,0,0,0,0,0,0,0,0,0,0,1,1,472
1,1,1,1,1,1,0,0,0,0,0,0,0,0,0,0,0,0,0,0,0,0,0,0,0,0,0,0,0,0,0,1,1,473
1,1,1,1,1,1,0,0,0,0,0,0,0,0,0,0,0,0,0,0,0,0,0,0,0,0,0,0,0,0,0,1,1,474
1,1,1,1,1,1,0,0,0,0,0,0,0,0,0,0,0,0,0,0,0,0,0,0,0,0,0,0,0,0,0,1,1,475
1,1,1,1,1,1,0,0,0,0,0,0,0,0,0,0,0,0,0,0,0,0,0,0,0,0,0,0,0,0,0,1,1,476
1,1,1,1,1,1,0,0,0,0,0,0,0,0,0,0,0,0,0,0,0,0,0,0,0,0,0,0,0,0,0,1,1,477
1,1,1,1,1,1,0,0,0,0,0,0,0,0,0,0,0,0,0,0,0,0,0,0,0,0,0,0,0,0,0,1,1,478
1,1,1,1,1,1,0,0,0,0,0,0,0,0,0,0,0,0,0,0,0,0,0,0,0,0,0,0,0,0,0,1,1,479
1,1,1,1,1,1,0,0,0,0,0,0,0,0,0,0,0,0,0,0,0,0,0,0,0,0,0,0,0,0,0,1,1,480
1,1,1,1,1,1,0,0,0,0,0,0,0,0,0,0,0,0,0,0,0,0,0,0,0,0,0,0,0,0,0,1,1,481
1,1,1,1,1,1,0,0,0,0,0,0,0,0,0,0,0,0,0,0,0,0,0,0,0,0,0,0,0,0,0,1,1,482
1,1,1,1,1,1,0,0,0,0,0,0,0,0,0,0,0,0,0,0,0,0,0,0,0,0,0,0,0,0,0,1,1,483
1,1,1,1,1,1,0,0,0,0,0,0,0,0,0,0,0,0,0,0,0,0,0,0,0,0,0,0,0,0,0,1,1,484
1,1,1,1,1,1,0,0,0,0,0,0,0,0,0,0,0,0,0,0,0,0,0,0,0,0,0,0,0,0,0,1,1,485
1,1,1,1,1,1,0,0,0,0,0,0,0,0,0,0,0,0,0,0,0,0,0,0,0,0,0,0,0,0,0,1,1,486
1,1,1,1,1,1,0,0,0,0,0,0,0,0,0,0,0,0,0,0,0,0,0,0,0,0,0,0,0,0,0,1,1,487
1,1,1,1,1,1,0,0,0,0,0,0,0,0,0,0,0,0,0,0,0,0,0,0,0,0,0,0,0,0,0,1,1,488
1,1,1,1,1,1,0,0,0,0,0,0,0,0,0,0,0,0,0,0,0,0,0,0,0,0,0,0,0,0,0,1,1,489
1,1,1,1,1,1,0,0,0,0,0,0,0,0,0,0,0,0,0,0,0,0,0,0,0,0,0,0,0,0,0,1,1,490
1,1,1,1,1,1,0,0,0,0,0,0,0,0,0,0,0,0,0,0,0,0,0,0,0,0,0,0,0,0,0,1,1,491
1,1,1,1,1,1,0,0,0,0,0,0,0,0,0,0,0,0,0,0,0,0,0,0,0,0,0,0,0,0,0,1,1,492
1,1,1,1,1,1,0,0,0,0,0,0,0,0,0,0,0,0,0,0,0,0,0,0,0,0,0,0,0,0,0,1,1,493
1,1,1,1,1,1,0,0,0,0,0,0,0,0,0,0,0,0,0,0,0,0,0,0,0,0,0,0,0,0,0,1,1,494
1,1,1,1,1,1,0,0,0,0,0,0,0,0,0,0,0,0,0,0,0,0,0,0,0,0,0,0,0,0,0,1,1,495
1,1,1,1,1,1,0,0,0,0,0,0,0,0,0,0,0,0,0,0,0,0,0,0,0,0,0,0,0,0,0,1,1,496
1,1,1,1,1,1,0,0,0,0,0,0,0,0,0,0,0,0,0,0,0,0,0,0,0,0,0,0,0,0,0,1,1,497
1,1,1,1,1,1,0,0,0,0,0,0,0,0,0,0,0,0,0,0,0,0,0,0,0,0,0,0,0,0,0,1,1,498
1,1,1,1,1,1,0,0,0,0,0,0,0,0,0,0,0,0,0,0,0,0,0,0,0,0,0,0,0,0,0,1,1,499
1,1,1,1,1,1,0,0,0,0,0,0,0,0,0,0,0,0,0,0,0,0,0,0,0,0,0,0,0,0,0,1,1,500
1,1,1,1,1,1,0,0,0,0,0,0,0,0,0,0,0,0,0,0,0,0,0,0,0,0,0,0,0,0,0,1,1,501
1,1,1,1,1,1,0,0,0,0,0,0,0,0,0,0,0,0,0,0,0,0,0,0,0,0,0,0,0,0,0,1,1,502
1,1,1,1,1,1,0,0,0,0,0,0,0,0,0,0,0,0,0,0,0,0,0,0,0,0,0,0,0,0,0,1,1,503
1,1,1,1,1,1,0,0,0,0,0,0,0,0,0,0,0,0,0,0,0,0,0,0,0,0,0,0,0,0,0,1,1,504
1,1,1,1,1,1,0,0,0,0,0,0,0,0,0,0,0,0,0,0,0,0,0,0,0,0,0,0,0,0,0,1,1,505
1,1,1,1,1,1,0,0,0,0,0,0,0,0,0,0,0,0,0,0,0,0,0,0,0,0,0,0,0,0,0,1,1,506
1,1,1,1,1,1,0,0,0,0,0,0,0,0,0,0,0,0,0,0,0,0,0,0,0,0,0,0,0,0,0,1,1,507
1,1,1,1,1,1,0,0,0,0,0,0,0,0,0,0,0,0,0,0,0,0,0,0,0,0,0,0,0,0,0,1,1,508
1,1,1,1,1,1,0,0,0,0,0,0,0,0,0,0,0,0,0,0,0,0,0,0,0,0,0,0,0,0,0,1,1,509
1,1,1,1,1,1,0,0,0,0,0,0,0,0,0,0,0,0,0,0,0,0,0,0,0,0,0,0,0,0,0,1,1,510
1,1,1,1,1,1,0,0,0,0,0,0,0,0,0,0,0,0,0,0,0,0,0,0,0,0,0,0,0,0,0,1,1,511
10,10,10,10,10,2,8,8,8,8,8,1,1,1,1,0,0,0,0,0,0,0,0,0,0,0,1,0,0,7,0,10,6,129
10,10,10,10,10,4,6,6,6,6,6,1,1,1,1,0,0,0,0,0,0,0,0,0,0,0,1,0,0,5,0,10,6,130
10,10,13,10,10,10,3,3,3,3,3,3,3,3,0,0,0,0,0,0,0,0,0,0,0,0,0,3,0,0,0,10,6,131
10,10,10,10,10,2,8,9,8,8,8,1,1,1,1,0,0,0,0,0,0,0,0,0,0,0,1,0,1,7,0,10,6,132
10,10,10,10,10,10,0,0,0,0,0,0,0,0,0,0,0,0,0,0,0,0,0,0,0,0,0,0,0,0,0,10,6,133
10,10,10,10,10,4,6,6,6,6,6,2,2,1,1,0,0,0,0,0,0,0,0,0,0,0,1,0,1,4,0,10,6,134
10,10,10,10,10,10,0,0,0,0,0,0,0,0,0,0,0,0,0,0,0,0,0,0,0,0,0,0,0,0,0,10,6,135
10,10,10,10,10,10,0,0,0,0,0,0,0,0,0,0,0,0,0,0,0,0,0,0,0,0,0,0,0,0,0,10,6,136
10,10,10,10,10,10,0,0,0,0,0,0,0,0,0,0,0,0,0,0,0,0,0,0,0,0,0,0,0,0,0,10,6,137
10,10,11,10,10,10,1,1,1,1,1,1,1,1,0,0,0,0,0,0,0,0,0,0,0,0,0,1,0,0,0,10,6,138
10,10,12,10,10,4,8,8,8,8,8,4,4,3,1,0,0,0,0,0,0,0,0,0,0,0,1,2,1,4,0,10,6,139
10,10,11,10,10,10,1,1,1,1,1,1,1,1,0,0,0,0,0,0,0,0,0,0,0,0,0,1,0,0,0,10,6,140
10,10,16,10,10,10,6,6,6,6,6,6,6,6,0,0,0,0,0,0,0,0,0,0,0,0,0,6,0,0,0,10,6,141
10,10,10,10,10,10,0,0,0,0,0,0,0,0,0,0,0,0,0,0,0,0,0,0,0,0,0,0,0,0,0,10,6,142
10,10,10,10,10,2,8,9,8,8,8,1,1,1,1,0,0,0,0,0,0,0,0,0,0,0,1,0,1,7,0,10,6,143
10,10,10,10,10,10,0,0,0,0,0,0,0,0,0,0,0,0,0,0,0,0,0,0,0,0,0,0,0,0,0,10,6,144
10,10,10,10,10,2,8,8,8,8,8,1,1,1,1,0,0,0,0,0,0,0,0,0,0,0,1,0,0,7,0,10,6,145
10,10,10,10,10,2,8,8,8,8,8,1,1,1,1,0,0,0,0,0,0,0,0,0,0,0,1,0,0,7,0,10,6,146
10,10,10,10,10,10,0,0,0,0,0,0,0,0,0,0,0,0,0,0,0,0,0,0,0,0,0,0,0,0,0,10,6,147
10,10,10,10,10,10,0,0,0,0,0,0,0,0,0,0,0,0,0,0,0,0,0,0,0,0,0,0,0,0,0,10,6,148
10,10,10,10,10,6,4,4,4,4,4,1,1,1,1,0,0,0,0,0,0,0,0,0,0,0,1,0,0,3,0,10,6,149
10,10,10,10,10,4,6,6,6,6,6,2,2,1,1,0,0,0,0,0,0,0,0,0,0,0,1,0,1,4,0,10,6,150
10,10,10,10,10,10,0,0,0,0,0,0,0,0,0,0,0,0,0,0,0,0,0,0,0,0,0,0,0,0,0,10,6,151
10,10,10,10,10,10,0,0,0,0,0,0,0,0,0,0,0,0,0,0,0,0,0,0,0,0,0,0,0,0,0,10,6,152
10,10,10,10,10,6,4,4,4,4,4,2,2,1,1,0,0,0,0,0,0,0,0,0,0,0,1,0,1,2,0,10,6,153
10,10,13,10,10,10,3,3,3,3,3,3,3,3,0,0,0,0,0,0,0,0,0,0,0,0,0,3,0,0,0,10,6,154
10,10,10,10,10,10,0,0,0,0,0,0,0,0,0,0,0,0,0,0,0,0,0,0,0,0,0,0,0,0,0,10,6,155
10,10,10,10,10,6,4,4,4,4,4,2,2,1,1,0,0,0,0,0,0,0,0,0,0,0,1,0,1,2,0,10,6,156
10,10,10,10,10,2,8,8,8,8,8,1,1,1,1,0,0,0,0,0,0,0,0,0,0,0,1,0,0,7,0,10,6,157
10,10,10,10,10,4,6,6,6,6,6,2,2,1,1,0,0,0,0,0,0,0,0,0,0,0,1,0,1,4,0,10,6,158
10,10,10,10,10,10,0,0,0,0,0,0,0,0,0,0,0,0,0,0,0,0,0,0,0,0,0,0,0,0,0,10,6,159
10,10,11,10,10,10,1,1,1,1,1,1,1,1,0,0,0,0,0,0,0,0,0,0,0,0,0,1,0,0,0,10,6,160
10,10,10,10,10,2,8,9,8,8,8,1,1,1,1,0,0,0,0,0,0,0,0,0,0,0,1,0,1,7,0,10,6,161
10,1,1,1,1,1,0,0,0,0,0,0,0,0,0,0,0,0,0,0,0,0,0,0,0,0,0,0,0,0,0,10,5,162
10,1,1,1,1,1,0,0,0,0,0,0,0,0,0,0,0,0,0,0,0,0,0,0,0,0,0,0,0,0,0,10,4,163
10,8,8,8,8,8,0,0,0,0,0,0,0,0,0,0,0,0,0,0,0,0,0,0,0,0,0,0,0,0,0,10,7,164
10,8,8,8,8,8,0,0,0,0,0,0,0,0,0,0,0,0,0,0,0,0,0,0,0,0,0,0,0,0,0,10,6,165
10,3,3,3,3,3,0,0,0,0,0,0,0,0,0,0,0,0,0,0,0,0,0,0,0,0,0,0,0,0,0,10,5,166
10,3,3,3,3,3,0,0,0,0,0,0,0,0,0,0,0,0,0,0,0,0,0,0,0,0,0,0,0,0,0,10,5,167
10,6,6,6,6,6,0,0,0,0,0,0,0,0,0,0,0,0,0,0,0,0,0,0,0,0,0,0,0,0,0,10,5,168
10,6,6,6,6,1,5,6,5,5,5,1,1,0,0,0,0,0,0,0,0,0,0,0,0,0,0,0,1,5,0,10,5,169
10,5,5,5,5,3,2,2,2,2,2,0,0,0,0,0,0,0,0,0,0,0,0,0,0,0,0,0,0,2,0,10,5,170
10,5,5,5,5,1,4,4,4,4,4,0,0,0,0,0,0,0,0,0,0,0,0,0,0,0,0,0,0,4,0,10,5,171
10,5,5,5,5,4,1,1,1,1,1,1,1,1,1,0,0,0,0,0,0,0,0,0,0,0,1,0,0,0,0,10,5,172
10,5,5,5,5,1,4,4,4,4,4,0,0,0,0,0,0,0,0,0,0,0,0,0,0,0,0,0,0,4,0,10,5,173
10,5,5,5,5,1,4,5,4,4,4,1,1,0,0,0,0,0,0,0,0,0,0,0,0,0,0,0,1,4,0,10,5,174
10,5,5,5,5,5,0,0,0,0,0,0,0,0,0,0,0,0,0,0,0,0,0,0,0,0,0,0,0,0,0,10,5,175
10,5,5,5,5,1,4,4,4,4,4,1,1,0,0,0,0,0,0,0,0,0,0,0,0,0,0,0,1,3,0,10,5,176
10,5,5,5,5,1,4,5,4,4,4,1,1,0,0,0,0,0,0,0,0,0,0,0,0,0,0,0,1,4,0,10,5,177
10,5,5,5,5,4,1,1,1,1,1,1,1,1,1,0,0,0,0,0,0,0,0,0,0,0,1,0,0,0,0,10,5,178
10,5,6,5,5,2,4,4,4,4,4,2,2,2,1,0,0,0,0,0,0,0,0,0,0,0,1,1,0,2,0,10,5,179
10,5,5,5,5,3,2,2,2,2,2,0,0,0,0,0,0,0,0,0,0,0,0,0,0,0,0,0,0,2,0,10,5,180
10,5,7,5,5,5,2,2,2,2,2,2,2,2,0,0,0,0,0,0,0,0,0,0,0,0,0,2,0,0,0,10,5,181
10,5,5,5,5,3,2,2,2,2,2,0,0,0,0,0,0,0,0,0,0,0,0,0,0,0,0,0,0,2,0,10,5,182
10,5,5,5,5,5,0,0,0,0,0,0,0,0,0,0,0,0,0,0,0,0,0,0,0,0,0,0,0,0,0,10,5,183
10,5,5,5,5,3,2,2,2,2,2,0,0,0,0,0,0,0,0,0,0,0,0,0,0,0,0,0,0,2,0,10,5,184
10,5,5,5,5,1,4,4,4,4,4,1,1,0,0,0,0,0,0,0,0,0,0,0,0,0,0,0,1,3,0,10,5,185
10,5,5,5,5,5,0,0,0,0,0,0,0,0,0,0,0,0,0,0,0,0,0,0,0,0,0,0,0,0,0,10,5,186
10,5,5,5,5,2,3,3,3,3,3,1,1,1,1,0,0,0,0,0,0,0,0,0,0,0,1,0,0,2,0,10,5,187
10,5,5,5,5,3,2,2,2,2,2,0,0,0,0,0,0,0,0,0,0,0,0,0,0,0,0,0,0,2,0,10,5,188
10,5,6,5,5,2,4,4,4,4,4,2,2,2,1,0,0,0,0,0,0,0,0,0,0,0,1,1,0,2,0,10,5,189
10,5,5,5,5,5,0,0,0,0,0,0,0,0,0,0,0,0,0,0,0,0,0,0,0,0,0,0,0,0,0,10,5,190
10,5,5,5,5,5,0,0,0,0,0,0,0,0,0,0,0,0,0,0,0,0,0,0,0,0,0,0,0,0,0,10,5,191
10,5,5,5,5,1,4,5,4,4,4,2,1,0,0,0,0,0,0,0,0,0,0,0,0,0,0,0,2,3,0,10,5,192
10,7,7,7,7,1,6,6,6,6,6,2,2,1,1,0,0,0,0,0,0,0,0,0,0,0,1,0,1,4,0,10,5,193
10,7,7,7,7,4,3,3,3,3,3,1,1,1,1,0,0,0,0,0,0,0,0,0,0,0,1,0,0,2,0,10,5,194
10,7,7,7,7,3,4,4,4,4,4,2,2,2,1,0,0,0,0,0,0,0,0,0,0,0,1,1,0,2,0,10,5,195
10,7,7,7,7,2,5,5,5,5,5,2,2,1,1,0,0,0,0,0,0,0,0,0,0,0,1,0,1,3,0,10,5,196
10,7,7,7,7,1,6,8,6,6,6,2,2,1,1,0,0,0,0,0,0,0,0,0,0,0,1,0,2,5,0,10,5,197
10,7,8,7,7,7,1,1,1,1,1,1,1,1,0,0,0,0,0,0,0,0,0,0,0,0,0,1,0,0,0,10,5,198
10,7,9,7,7,7,2,2,2,2,2,2,2,2,0,0,0,0,0,0,0,0,0,0,0,0,0,2,0,0,0,10,5,199
10,7,7,7,7,1,6,7,6,6,6,2,2,1,1,0,0,0,0,0,0,0,0,0,0,0,1,0,2,4,0,10,5,200
10,7,7,7,7,1,6,6,6,6,6,2,2,1,1,0,0,0,0,0,0,0,0,0,0,0,1,0,1,4,0,10,5,201
10,7,7,7,7,7,0,0,0,0,0,0,0,0,0,0,0,0,0,0,0,0,0,0,0,0,0,0,0,0,0,10,5,202
10,7,8,7,7,4,4,4,4,4,4,3,3,2,1,0,0,0,0,0,0,0,0,0,0,0,1,1,1,1,0,10,5,203
10,7,7,7,7,7,0,0,0,0,0,0,0,0,0,0,0,0,0,0,0,0,0,0,0,0,0,0,0,0,0,10,5,204
10,7,7,7,7,1,6,7,6,6,6,2,2,1,1,0,0,0,0,0,0,0,0,0,0,0,1,0,2,4,0,10,5,205
10,7,7,7,7,1,6,7,6,6,6,2,2,1,1,0,0,0,0,0,0,0,0,0,0,0,1,0,2,4,0,10,5,206
10,7,7,7,7,7,0,0,0,0,0,0,0,0,0,0,0,0,0,0,0,0,0,0,0,0,0,0,0,0,0,10,5,207
10,7,7,7,7,7,0,0,0,0,0,0,0,0,0,0,0,0,0,0,0,0,0,0,0,0,0,0,0,0,0,10,5,208
10,7,7,7,7,4,3,3,3,3,3,1,1,1,1,0,0,0,0,0,0,0,0,0,0,0,1,0,0,2,0,10,5,209
10,7,7,7,7,6,1,1,1,1,1,1,1,1,1,0,0,0,0,0,0,0,0,0,0,0,1,0,0,0,0,10,5,210
10,7,8,7,7,7,1,1,1,1,1,1,1,1,0,0,0,0,0,0,0,0,0,0,0,0,0,1,0,0,0,10,5,211
10,7,7,7,7,1,6,7,6,6,6,1,1,1,1,0,0,0,0,0,0,0,0,0,0,0,1,0,1,5,0,10,5,212
10,7,7,7,7,7,0,0,0,0,0,0,0,0,0,0,0,0,0,0,0,0,0,0,0,0,0,0,0,0,0,10,5,213
10,7,7,7,7,1,6,6,6,6,6,2,2,1,1,0,0,0,0,0,0,0,0,0,0,0,1,0,1,4,0,10,5,214
10,7,7,7,7,1,6,7,6,6,6,1,1,1,1,0,0,0,0,0,0,0,0,0,0,0,1,0,1,5,0,10,5,215
10,7,7,7,7,1,6,7,6,6,6,2,2,1,1,0,0,0,0,0,0,0,0,0,0,0,1,0,2,4,0,10,5,216
10,7,7,7,7,1,6,7,6,6,6,2,2,1,1,0,0,0,0,0,0,0,0,0,0,0,1,0,2,4,0,10,5,217
10,7,7,7,7,4,3,3,3,3,3,2,2,1,1,0,0,0,0,0,0,0,0,0,0,0,1,0,1,1,0,10,5,218
10,7,7,7,7,2,5,5,5,5,5,2,2,1,1,0,0,0,0,0,0,0,0,0,0,0,1,0,1,3,0,10,5,219
10,7,7,7,7,7,0,0,0,0,0,0,0,0,0,0,0,0,0,0,0,0,0,0,0,0,0,0,0,0,0,10,5,220
10,7,8,7,7,6,2,2,2,2,2,2,2,2,1,0,0,0,0,0,0,0,0,0,0,0,1,1,0,0,0,10,5,221
10,7,7,7,7,1,6,6,6,6,6,2,2,1,1,0,0,0,0,0,0,0,0,0,0,0,1,0,1,4,0,10,5,222
10,7,7,7,7,7,0,0,0,0,0,0,0,0,0,0,0,0,0,0,0,0,0,0,0,0,0,0,0,0,0,10,5,223
10,7,8,7,7,7,1,1,1,1,1,1,1,1,0,0,0,0,0,0,0,0,0,0,0,0,0,1,0,0,0,10,5,224
10,10,10,10,10,2,8,8,8,8,8,1,1,1,1,0,0,0,0,0,0,0,0,0,0,0,1,0,0,7,0,10,5,225
10,10,10,10,10,2,8,8,8,8,8,1,1,1,1,0,0,0,0,0,0,0,0,0,0,0,1,0,0,7,0,10,6,226
10,10,10,10,10,10,0,0,0,0,0,0,0,0,0,0,0,0,0,0,0,0,0,0,0,0,0,0,0,0,0,10,5,227
10,10,10,10,10,2,8,9,8,8,8,1,1,1,1,0,0,0,0,0,0,0,0,0,0,0,1,0,1,7,0,10,6,228
10,10,10,10,10,2,8,10,8,8,8,2,2,1,1,0,0,0,0,0,0,0,0,0,0,0,1,0,2,7,0,10,5,229
10,10,10,10,10,6,4,4,4,4,4,1,1,1,1,0,0,0,0,0,0,0,0,0,0,0,1,0,0,3,0,10,6,230
10,10,10,10,10,2,8,10,8,8,8,2,2,1,1,0,0,0,0,0,0,0,0,0,0,0,1,0,2,7,0,10,5,231
10,10,10,10,10,10,0,0,0,0,0,0,0,0,0,0,0,0,0,0,0,0,0,0,0,0,0,0,0,0,0,10,5,232
10,10,10,10,10,2,8,9,8,8,8,1,1,1,1,0,0,0,0,0,0,0,0,0,0,0,1,0,1,7,0,10,5,233
10,10,12,10,10,6,6,6,6,6,6,3,3,3,1,0,0,0,0,0,0,0,0,0,0,0,1,2,0,3,0,10,5,234
10,10,10,10,10,2,8,8,8,8,8,2,2,1,1,0,0,0,0,0,0,0,0,0,0,0,1,0,1,6,0,10,5,235
10,10,13,10,10,10,3,3,3,3,3,3,3,3,0,0,0,0,0,0,0,0,0,0,0,0,0,3,0,0,0,10,5,236
10,10,10,10,10,10,0,0,0,0,0,0,0,0,0,0,0,0,0,0,0,0,0,0,0,0,0,0,0,0,0,10,5,237
10,10,12,10,10,6,6,7,6,6,6,3,3,3,1,0,0,0,0,0,0,0,0,0,0,0,1,2,1,3,0,10,5,238
10,10,12,10,10,10,2,2,2,2,2,2,2,2,0,0,0,0,0,0,0,0,0,0,0,0,0,2,0,0,0,10,5,239
10,10,11,10,10,10,1,1,1,1,1,1,1,1,0,0,0,0,0,0,0,0,0,0,0,0,0,1,0,0,0,10,5,240
10,10,10,10,10,5,5,5,5,5,5,2,2,2,1,0,0,0,0,0,0,0,0,0,0,0,1,1,0,3,0,10,5,241
10,10,11,10,10,6,5,5,5,5,5,2,2,2,1,0,0,0,0,0,0,0,0,0,0,0,1,1,0,3,0,10,5,242
10,10,11,10,10,10,1,1,1,1,1,1,1,1,0,0,0,0,0,0,0,0,0,0,0,0,0,1,0,0,0,10,5,243
10,10,10,10,10,10,0,0,0,0,0,0,0,0,0,0,0,0,0,0,0,0,0,0,0,0,0,0,0,0,0,10,5,244
10,10,11,10,10,10,1,1,1,1,1,1,1,1,0,0,0,0,0,0,0,0,0,0,0,0,0,1,0,0,0,10,5,245
10,10,10,10,10,2,8,9,8,8,8,2,2,1,1,0,0,0,0,0,0,0,0,0,0,0,1,0,2,6,0,10,5,246
10,10,10,10,10,2,8,10,8,8,8,2,2,1,1,0,0,0,0,0,0,0,0,0,0,0,1,0,2,7,0,10,5,247
10,10,10,10,10,2,8,9,8,8,8,1,1,1,1,0,0,0,0,0,0,0,0,0,0,0,1,0,1,7,0,10,5,248
10,10,10,10,10,2,8,8,8,8,8,2,2,1,1,0,0,0,0,0,0,0,0,0,0,0,1,0,1,6,0,10,5,249
10,10,10,10,10,10,0,0,0,0,0,0,0,0,0,0,0,0,0,0,0,0,0,0,0,0,0,0,0,0,0,10,5,250
10,10,10,10,10,2,8,8,8,8,8,1,1,1,1,0,0,0,0,0,0,0,0,0,0,0,1,0,0,7,0,10,5,251
10,10,14,10,10,10,4,4,4,4,4,4,4,4,0,0,0,0,0,0,0,0,0,0,0,0,0,4,0,0,0,10,5,252
10,10,11,10,10,10,1,1,1,1,1,1,1,1,0,0,0,0,0,0,0,0,0,0,0,0,0,1,0,0,0,10,5,253
10,10,10,10,10,2,8,9,8,8,8,1,1,1,1,0,0,0,0,0,0,0,0,0,0,0,1,0,1,7,0,10,5,254
10,10,10,10,10,7,3,3,3,3,3,2,2,2,1,0,0,0,0,0,0,0,0,0,0,0,1,1,0,1,0,10,5,255
10,10,10,10,10,2,8,8,8,8,8,1,0,0,0,0,0,0,0,0,0,0,0,0,0,0,0,0,1,7,0,10,5,256
10,10,10,10,10,4,6,6,6,6,6,1,1,1,1,0,0,0,0,0,0,0,0,0,0,0,1,0,0,5,0,10,5,257
10,10,10,10,10,2,8,9,8,8,8,1,1,1,1,0,0,0,0,0,0,0,0,0,0,0,1,0,1,7,0,10,5,258
10,10,11,10,10,6,5,7,5,5,5,3,3,2,1,0,0,0,0,0,0,0,0,0,0,0,1,1,2,3,0,10,5,259
10,10,10,10,10,4,6,6,6,6,6,1,1,1,1,0,0,0,0,0,0,0,0,0,0,0,1,0,0,5,0,10,5,260
10,10,11,10,10,6,5,6,5,5,5,2,2,2,1,0,0,0,0,0,0,0,0,0,0,0,1,1,1,3,0,10,5,261
10,10,13,10,10,10,3,3,3,3,3,3,3,3,0,0,0,0,0,0,0,0,0,0,0,0,0,3,0,0,0,10,5,262
10,10,10,10,10,10,0,0,0,0,0,0,0,0,0,0,0,0,0,0,0,0,0,0,0,0,0,0,0,0,0,10,5,263
10,10,10,10,10,2,8,9,8,8,8,1,1,1,1,0,0,0,0,0,0,0,0,0,0,0,1,0,1,7,0,10,5,264
10,10,10,10,10,2,8,9,8,8,8,1,1,1,1,0,0,0,0,0,0,0,0,0,0,0,1,0,1,7,0,10,5,265
10,10,12,10,10,10,2,2,2,2,2,2,2,2,0,0,0,0,0,0,0,0,0,0,0,0,0,2,0,0,0,10,5,266
10,10,11,10,10,10,1,1,1,1,1,1,1,1,0,0,0,0,0,0,0,0,0,0,0,0,0,1,0,0,0,10,5,267
10,10,10,10,10,4,6,6,6,6,6,2,2,1,1,0,0,0,0,0,0,0,0,0,0,0,1,0,1,4,0,10,5,268
10,10,11,10,10,5,6,7,6,6,6,2,2,2,1,0,0,0,0,0,0,0,0,0,0,0,1,1,1,4,0,10,5,269
10,10,10,10,10,10,0,0,0,0,0,0,0,0,0,0,0,0,0,0,0,0,0,0,0,0,0,0,0,0,0,10,5,270
10,10,10,10,10,10,0,0,0,0,0,0,0,0,0,0,0,0,0,0,0,0,0,0,0,0,0,0,0,0,0,10,5,271
10,10,11,10,10,10,1,1,1,1,1,1,1,1,0,0,0,0,0,0,0,0,0,0,0,0,0,1,0,0,0,10,5,272
10,10,10,10,10,6,4,4,4,4,4,1,1,1,1,0,0,0,0,0,0,0,0,0,0,0,1,0,0,3,0,10,5,273
10,10,12,10,10,10,2,2,2,2,2,2,2,2,0,0,0,0,0,0,0,0,0,0,0,0,0,2,0,0,0,10,5,274
10,10,11,10,10,10,1,1,1,1,1,1,1,1,0,0,0,0,0,0,0,0,0,0,0,0,0,1,0,0,0,10,5,275
10,10,11,10,10,10,1,1,1,1,1,1,1,1,0,0,0,0,0,0,0,0,0,0,0,0,0,1,0,0,0,10,5,276
10,10,10,10,10,10,0,0,0,0,0,0,0,0,0,0,0,0,0,0,0,0,0,0,0,0,0,0,0,0,0,10,5,277
10,10,11,10,10,4,7,8,7,7,7,3,3,2,1,0,0,0,0,0,0,0,0,0,0,0,1,1,1,5,0,10,5,278
10,10,12,10,10,10,2,2,2,2,2,2,2,2,0,0,0,0,0,0,0,0,0,0,0,0,0,2,0,0,0,10,5,279
10,10,11,10,10,10,1,1,1,1,1,1,1,1,0,0,0,0,0,0,0,0,0,0,0,0,0,1,0,0,0,10,5,280
10,10,12,10,10,10,2,2,2,2,2,2,2,2,0,0,0,0,0,0,0,0,0,0,0,0,0,2,0,0,0,10,5,281
10,10,13,10,10,10,3,3,3,3,3,3,3,3,0,0,0,0,0,0,0,0,0,0,0,0,0,3,0,0,0,10,5,282
10,10,10,10,10,10,0,0,0,0,0,0,0,0,0,0,0,0,0,0,0,0,0,0,0,0,0,0,0,0,0,10,5,283
10,10,10,10,10,10,0,0,0,0,0,0,0,0,0,0,0,0,0,0,0,0,0,0,0,0,0,0,0,0,0,10,5,284
10,10,13,10,10,10,3,3,3,3,3,3,3,3,0,0,0,0,0,0,0,0,0,0,0,0,0,3,0,0,0,10,5,285
10,10,10,10,10,2,8,9,8,8,8,1,1,1,1,0,0,0,0,0,0,0,0,0,0,0,1,0,1,7,0,10,5,286
10,10,11,10,10,10,1,1,1,1,1,1,1,1,0,0,0,0,0,0,0,0,0,0,0,0,0,1,0,0,0,10,5,287
10,10,14,10,10,10,4,4,4,4,4,4,4,4,0,0,0,0,0,0,0,0,0,0,0,0,0,4,0,0,0,10,5,288
10,10,12,10,10,10,2,2,2,2,2,2,2,2,0,0,0,0,0,0,0,0,0,0,0,0,0,2,0,0,0,10,5,289
10,10,10,10,10,2,8,8,8,8,8,1,1,1,1,0,0,0,0,0,0,0,0,0,0,0,1,0,0,7,0,10,6,290
10,10,10,10,10,10,0,0,0,0,0,0,0,0,0,0,0,0,0,0,0,0,0,0,0,0,0,0,0,0,0,10,5,291
10,10,10,10,10,2,8,9,8,8,8,1,1,1,1,0,0,0,0,0,0,0,0,0,0,0,1,0,1,7,0,10,6,292
10,10,11,10,10,10,1,1,1,1,1,1,1,1,0,0,0,0,0,0,0,0,0,0,0,0,0,1,0,0,0,10,5,293
10,10,10,10,10,10,0,0,0,0,0,0,0,0,0,0,0,0,0,0,0,0,0,0,0,0,0,0,0,0,0,10,6,294
10,10,10,10,10,10,0,0,0,0,0,0,0,0,0,0,0,0,0,0,0,0,0,0,0,0,0,0,0,0,0,10,5,295
10,10,10,10,10,10,0,0,0,0,0,0,0,0,0,0,0,0,0,0,0,0,0,0,0,0,0,0,0,0,0,10,6,296
10,10,10,10,10,10,0,0,0,0,0,0,0,0,0,0,0,0,0,0,0,0,0,0,0,0,0,0,0,0,0,10,6,297
10,10,10,10,10,6,4,4,4,4,4,1,1,1,1,0,0,0,0,0,0,0,0,0,0,0,1,0,0,3,0,10,4,298
10,10,10,10,10,10,0,0,0,0,0,0,0,0,0,0,0,0,0,0,0,0,0,0,0,0,0,0,0,0,0,10,6,299
10,10,10,10,10,4,6,6,6,6,6,2,2,1,1,0,0,0,0,0,0,0,0,0,0,0,1,0,1,4,0,10,5,300
10,10,10,10,10,4,6,7,6,6,6,1,1,1,1,0,0,0,0,0,0,0,0,0,0,0,1,0,1,5,0,10,6,301
10,10,10,10,10,10,0,0,0,0,0,0,0,0,0,0,0,0,0,0,0,0,0,0,0,0,0,0,0,0,0,10,6,302
10,10,14,10,10,10,4,4,4,4,4,4,4,4,0,0,0,0,0,0,0,0,0,0,0,0,0,4,0,0,0,10,6,303
10,10,10,10,10,10,0,0,0,0,0,0,0,0,0,0,0,0,0,0,0,0,0,0,0,0,0,0,0,0,0,10,6,304
10,10,11,10,10,10,1,1,1,1,1,1,1,1,0,0,0,0,0,0,0,0,0,0,0,0,0,1,0,0,0,10,6,305
10,10,10,10,10,6,4,4,4,4,4,2,2,1,1,0,0,0,0,0,0,0,0,0,0,0,1,0,1,2,0,10,6,306
10,10,11,10,10,10,1,1,1,1,1,1,1,1,0,0,0,0,0,0,0,0,0,0,0,0,0,1,0,0,0,10,6,307
10,10,11,10,10,10,1,1,1,1,1,1,1,1,0,0,0,0,0,0,0,0,0,0,0,0,0,1,0,0,0,10,6,308
10,10,10,10,10,10,0,0,0,0,0,0,0,0,0,0,0,0,0,0,0,0,0,0,0,0,0,0,0,0,0,10,6,309
10,10,10,10,10,10,0,0,0,0,0,0,0,0,0,0,0,0,0,0,0,0,0,0,0,0,0,0,0,0,0,10,6,310
10,10,10,10,10,2,8,9,8,8,8,1,1,1,1,0,0,0,0,0,0,0,0,0,0,0,1,0,1,7,0,10,6,311
10,10,10,10,10,6,4,4,4,4,4,2,2,1,1,0,0,0,0,0,0,0,0,0,0,0,1,0,1,2,0,10,6,312
10,10,10,10,10,10,0,0,0,0,0,0,0,0,0,0,0,0,0,0,0,0,0,0,0,0,0,0,0,0,0,10,6,313
10,10,10,10,10,2,8,8,8,8,8,1,1,1,1,0,0,0,0,0,0,0,0,0,0,0,1,0,0,7,0,10,6,314
10,10,10,10,10,6,4,4,4,4,4,2,2,1,1,0,0,0,0,0,0,0,0,0,0,0,1,0,1,2,0,10,6,315
10,10,10,10,10,4,6,6,6,6,6,2,2,1,1,0,0,0,0,0,0,0,0,0,0,0,1,0,1,4,0,10,6,316
10,10,10,10,10,10,0,0,0,0,0,0,0,0,0,0,0,0,0,0,0,0,0,0,0,0,0,0,0,0,0,10,4,317
10,10,10,10,10,10,0,0,0,0,0,0,0,0,0,0,0,0,0,0,0,0,0,0,0,0,0,0,0,0,0,10,6,318
10,10,10,10,10,10,0,0,0,0,0,0,0,0,0,0,0,0,0,0,0,0,0,0,0,0,0,0,0,0,0,10,6,319
10,10,10,10,10,10,0,0,0,0,0,0,0,0,0,0,0,0,0,0,0,0,0,0,0,0,0,0,0,0,0,10,6,320
10,10,11,10,10,10,1,1,1,1,1,1,1,1,0,0,0,0,0,0,0,0,0,0,0,0,0,1,0,0,0,10,6,321
10,10,10,10,10,2,8,9,8,8,8,1,1,1,1,0,0,0,0,0,0,0,0,0,0,0,1,0,1,7,0,10,7,322
10,10,10,10,10,2,8,9,8,8,8,1,1,1,1,0,0,0,0,0,0,0,0,0,0,0,1,0,1,7,0,10,4,323
10,10,10,10,10,2,8,8,8,8,8,1,1,1,1,0,0,0,0,0,0,0,0,0,0,0,1,0,0,7,0,10,5,324
10,10,10,10,10,2,8,10,8,8,8,2,2,1,1,0,0,0,0,0,0,0,0,0,0,0,1,0,2,7,0,10,6,325
10,10,10,10,10,10,0,0,0,0,0,0,0,0,0,0,0,0,0,0,0,0,0,0,0,0,0,0,0,0,0,10,7,326
10,10,10,10,10,10,0,0,0,0,0,0,0,0,0,0,0,0,0,0,0,0,0,0,0,0,0,0,0,0,0,10,6,327
10,10,11,10,10,10,1,1,1,1,1,1,1,1,0,0,0,0,0,0,0,0,0,0,0,0,0,1,0,0,0,10,4,328
10,10,10,10,10,2,8,8,8,8,8,2,2,1,1,0,0,0,0,0,0,0,0,0,0,0,1,0,1,6,0,10,6,329
10,10,10,10,10,10,0,0,0,0,0,0,0,0,0,0,0,0,0,0,0,0,0,0,0,0,0,0,0,0,0,10,6,330
10,10,10,10,10,2,8,10,8,8,8,2,2,1,1,0,0,0,0,0,0,0,0,0,0,0,1,0,2,7,0,10,6,331
10,10,12,10,10,10,2,2,2,2,2,2,2,2,0,0,0,0,0,0,0,0,0,0,0,0,0,2,0,0,0,10,6,332
10,10,10,10,10,2,8,9,8,8,8,1,1,1,1,0,0,0,0,0,0,0,0,0,0,0,1,0,1,7,0,10,6,333
10,10,11,10,10,10,1,1,1,1,1,1,1,1,0,0,0,0,0,0,0,0,0,0,0,0,0,1,0,0,0,10,6,334
10,10,10,10,10,10,0,0,0,0,0,0,0,0,0,0,0,0,0,0,0,0,0,0,0,0,0,0,0,0,0,10,6,335
10,10,11,10,10,10,1,1,1,1,1,1,1,1,0,0,0,0,0,0,0,0,0,0,0,0,0,1,0,0,0,10,6,336
10,10,13,10,10,10,3,3,3,3,3,3,3,3,0,0,0,0,0,0,0,0,0,0,0,0,0,3,0,0,0,10,6,337
10,10,10,10,10,2,8,10,8,8,8,2,2,1,1,0,0,0,0,0,0,0,0,0,0,0,1,0,2,7,0,10,6,338
10,10,10,10,10,2,8,9,8,8,8,1,1,1,1,0,0,0,0,0,0,0,0,0,0,0,1,0,1,7,0,10,6,339
10,10,10,10,10,6,4,4,4,4,4,1,1,1,1,0,0,0,0,0,0,0,0,0,0,0,1,0,0,3,0,10,6,340
10,10,10,10,10,2,8,10,8,8,8,2,2,1,1,0,0,0,0,0,0,0,0,0,0,0,1,0,2,7,0,10,4,341
10,10,10,10,10,2,8,9,8,8,8,1,1,1,1,0,0,0,0,0,0,0,0,0,0,0,1,0,1,7,0,10,6,342
10,10,10,10,10,6,4,6,4,4,4,2,2,1,1,0,0,0,0,0,0,0,0,0,0,0,1,0,2,3,0,10,6,343
10,10,10,10,10,8,2,2,2,2,2,1,1,1,1,0,0,0,0,0,0,0,0,0,0,0,1,0,0,1,0,10,6,344
10,10,11,10,10,10,1,1,1,1,1,1,1,1,0,0,0,0,0,0,0,0,0,0,0,0,0,1,0,0,0,10,6,345
10,10,10,10,10,2,8,9,8,8,8,1,1,1,1,0,0,0,0,0,0,0,0,0,0,0,1,0,1,7,0,10,6,346
10,10,15,10,10,10,5,5,5,5,5,5,5,5,0,0,0,0,0,0,0,0,0,0,0,0,0,5,0,0,0,10,6,347
10,10,10,10,10,2,8,10,8,8,8,2,2,1,1,0,0,0,0,0,0,0,0,0,0,0,1,0,2,7,0,10,6,348
10,10,10,10,10,8,2,2,2,2,2,1,1,1,1,0,0,0,0,0,0,0,0,0,0,0,1,0,0,1,0,10,6,349
10,10,11,10,10,10,1,1,1,1,1,1,1,1,0,0,0,0,0,0,0,0,0,0,0,0,0,1,0,0,0,10,6,350
10,10,14,10,10,10,4,4,4,4,4,4,4,4,0,0,0,0,0,0,0,0,0,0,0,0,0,4,0,0,0,10,6,351
10,10,10,10,10,2,8,8,8,8,8,2,2,1,1,0,0,0,0,0,0,0,0,0,0,0,1,0,1,6,0,10,6,352
10,10,10,10,10,10,0,0,0,0,0,0,0,0,0,0,0,0,0,0,0,0,0,0,0,0,0,0,0,0,0,10,6,353
10,10,10,10,10,2,8,10,8,8,8,2,2,1,1,0,0,0,0,0,0,0,0,0,0,0,1,0,2,7,0,10,6,354
10,10,10,10,10,10,0,0,0,0,0,0,0,0,0,0,0,0,0,0,0,0,0,0,0,0,0,0,0,0,0,10,6,355
10,10,10,10,10,8,2,2,2,2,2,1,1,1,1,0,0,0,0,0,0,0,0,0,0,0,1,0,0,1,0,10,6,356
10,10,10,10,10,6,4,4,4,4,4,1,1,1,1,0,0,0,0,0,0,0,0,0,0,0,1,0,0,3,0,10,6,357
10,10,11,10,10,4,7,7,7,7,7,3,3,2,1,0,0,0,0,0,0,0,0,0,0,0,1,1,1,4,0,10,7,358
10,10,10,10,10,10,0,0,0,0,0,0,0,0,0,0,0,0,0,0,0,0,0,0,0,0,0,0,0,0,0,10,6,359
10,10,10,10,10,6,4,4,4,4,4,1,1,1,1,0,0,0,0,0,0,0,0,0,0,0,1,0,0,3,0,10,6,360
10,10,10,10,10,2,8,8,8,8,8,1,1,1,1,0,0,0,0,0,0,0,0,0,0,0,1,0,0,7,0,10,4,361
10,10,10,10,10,10,0,0,0,0,0,0,0,0,0,0,0,0,0,0,0,0,0,0,0,0,0,0,0,0,0,10,5,362
10,10,10,10,10,10,0,0,0,0,0,0,0,0,0,0,0,0,0,0,0,0,0,0,0,0,0,0,0,0,0,10,4,363
10,10,10,10,10,6,4,4,4,4,4,1,1,1,1,0,0,0,0,0,0,0,0,0,0,0,1,0,0,3,0,10,7,364
10,10,11,10,10,10,1,1,1,1,1,1,1,1,0,0,0,0,0,0,0,0,0,0,0,0,0,1,0,0,0,10,6,365
10,10,10,10,10,10,0,0,0,0,0,0,0,0,0,0,0,0,0,0,0,0,0,0,0,0,0,0,0,0,0,10,5,366
10,10,10,10,10,2,8,8,8,8,8,2,2,1,1,0,0,0,0,0,0,0,0,0,0,0,1,0,1,6,0,10,5,367
10,10,11,10,10,6,5,5,5,5,5,2,2,2,1,0,0,0,0,0,0,0,0,0,0,0,1,1,0,3,0,10,6,368
10,10,12,10,10,10,2,2,2,2,2,2,2,2,0,0,0,0,0,0,0,0,0,0,0,0,0,2,0,0,0,10,5,369
10,10,10,10,10,2,8,9,8,8,8,2,2,1,1,0,0,0,0,0,0,0,0,0,0,0,1,0,2,6,0,10,5,370
10,10,10,10,10,10,0,0,0,0,0,0,0,0,0,0,0,0,0,0,0,0,0,0,0,0,0,0,0,0,0,10,5,371
10,10,10,10,10,10,0,0,0,0,0,0,0,0,0,0,0,0,0,0,0,0,0,0,0,0,0,0,0,0,0,10,5,372
10,10,10,10,10,10,0,0,0,0,0,0,0,0,0,0,0,0,0,0,0,0,0,0,0,0,0,0,0,0,0,10,6,373
10,10,10,10,10,4,6,6,6,6,6,2,2,1,1,0,0,0,0,0,0,0,0,0,0,0,1,0,1,4,0,10,5,374
10,10,13,10,10,10,3,3,3,3,3,3,3,3,0,0,0,0,0,0,0,0,0,0,0,0,0,3,0,0,0,10,5,375
10,10,10,10,10,6,4,5,4,4,4,1,1,1,1,0,0,0,0,0,0,0,0,0,0,0,1,0,1,3,0,10,5,376
10,10,11,10,10,10,1,1,1,1,1,1,1,1,0,0,0,0,0,0,0,0,0,0,0,0,0,1,0,0,0,10,5,377
10,10,11,10,10,4,7,7,7,7,7,3,3,2,1,0,0,0,0,0,0,0,0,0,0,0,1,1,1,4,0,10,5,378
10,10,10,10,10,10,0,0,0,0,0,0,0,0,0,0,0,0,0,0,0,0,0,0,0,0,0,0,0,0,0,10,5,379
10,10,10,10,10,10,0,0,0,0,0,0,0,0,0,0,0,0,0,0,0,0,0,0,0,0,0,0,0,0,0,10,5,380
10,10,10,10,10,2,8,9,8,8,8,1,1,1,1,0,0,0,0,0,0,0,0,0,0,0,1,0,1,7,0,10,5,381
10,10,10,10,10,10,0,0,0,0,0,0,0,0,0,0,0,0,0,0,0,0,0,0,0,0,0,0,0,0,0,10,5,382
10,10,10,10,10,6,4,4,4,4,4,1,1,1,1,0,0,0,0,0,0,0,0,0,0,0,1,0,0,3,0,10,5,383
10,10,11,10,10,3,8,9,8,8,8,3,2,1,0,0,0,0,0,0,0,0,0,0,0,0,0,1,2,6,0,10,5,384
10,10,11,10,10,10,1,1,1,1,1,1,1,1,0,0,0,0,0,0,0,0,0,0,0,0,0,1,0,0,0,10,5,385
10,10,10,10,10,2,8,8,8,8,8,2,2,1,1,0,0,0,0,0,0,0,0,0,0,0,1,0,1,6,0,10,5,386
10,10,10,10,10,3,7,7,7,7,7,2,2,1,1,0,0,0,0,0,0,0,0,0,0,0,1,0,1,5,0,10,5,387
10,10,10,10,10,6,4,4,4,4,4,1,1,1,1,0,0,0,0,0,0,0,0,0,0,0,1,0,0,3,0,10,5,388
10,10,10,10,10,10,0,0,0,0,0,0,0,0,0,0,0,0,0,0,0,0,0,0,0,0,0,0,0,0,0,10,5,389
10,10,11,10,10,6,5,5,5,5,5,2,2,2,1,0,0,0,0,0,0,0,0,0,0,0,1,1,0,3,0,10,5,390
10,10,10,10,10,10,0,0,0,0,0,0,0,0,0,0,0,0,0,0,0,0,0,0,0,0,0,0,0,0,0,10,5,391
10,10,10,10,10,3,7,7,7,7,7,2,2,1,1,0,0,0,0,0,0,0,0,0,0,0,1,0,1,5,0,10,5,392
10,10,10,10,10,2,8,9,8,8,8,2,2,1,1,0,0,0,0,0,0,0,0,0,0,0,1,0,2,6,0,10,5,393
10,10,10,10,10,2,8,10,8,8,8,2,2,1,1,0,0,0,0,0,0,0,0,0,0,0,1,0,2,7,0,10,6,394
10,10,10,10,10,10,0,0,0,0,0,0,0,0,0,0,0,0,0,0,0,0,0,0,0,0,0,0,0,0,0,10,5,395
10,10,12,10,10,10,2,2,2,2,2,2,2,2,0,0,0,0,0,0,0,0,0,0,0,0,0,2,0,0,0,10,6,396
10,10,10,10,10,3,7,7,7,7,7,2,2,1,1,0,0,0,0,0,0,0,0,0,0,0,1,0,1,5,0,10,5,397
10,10,14,10,10,10,4,4,4,4,4,4,4,4,0,0,0,0,0,0,0,0,0,0,0,0,0,4,0,0,0,10,6,398
10,10,10,10,10,10,0,0,0,0,0,0,0,0,0,0,0,0,0,0,0,0,0,0,0,0,0,0,0,0,0,10,5,399
10,10,10,10,10,2,8,10,8,8,8,2,2,1,1,0,0,0,0,0,0,0,0,0,0,0,1,0,2,7,0,10,5,400
10,10,11,10,10,10,1,1,1,1,1,1,1,1,0,0,0,0,0,0,0,0,0,0,0,0,0,1,0,0,0,10,5,401
10,10,10,10,10,2,8,8,8,8,8,2,2,1,1,0,0,0,0,0,0,0,0,0,0,0,1,0,1,6,0,10,5,402
10,10,11,10,10,10,1,1,1,1,1,1,1,1,0,0,0,0,0,0,0,0,0,0,0,0,0,1,0,0,0,10,5,403
10,10,10,10,10,10,0,0,0,0,0,0,0,0,0,0,0,0,0,0,0,0,0,0,0,0,0,0,0,0,0,10,5,404
10,10,10,10,10,10,0,0,0,0,0,0,0,0,0,0,0,0,0,0,0,0,0,0,0,0,0,0,0,0,0,10,5,405
10,10,11,10,10,6,5,5,5,5,5,3,3,2,1,0,0,0,0,0,0,0,0,0,0,0,1,1,1,2,0,10,5,406
10,10,10,10,10,10,0,0,0,0,0,0,0,0,0,0,0,0,0,0,0,0,0,0,0,0,0,0,0,0,0,10,5,407
10,10,11,10,10,10,1,1,1,1,1,1,1,1,0,0,0,0,0,0,0,0,0,0,0,0,0,1,0,0,0,10,5,408
10,10,10,10,10,10,0,0,0,0,0,0,0,0,0,0,0,0,0,0,0,0,0,0,0,0,0,0,0,0,0,10,5,409
10,10,10,10,10,2,8,10,8,8,8,2,2,1,1,0,0,0,0,0,0,0,0,0,0,0,1,0,2,7,0,10,5,410
10,10,10,10,10,2,8,8,8,8,8,2,2,1,1,0,0,0,0,0,0,0,0,0,0,0,1,0,1,6,0,10,5,411
10,10,10,10,10,2,8,10,8,8,8,2,2,1,1,0,0,0,0,0,0,0,0,0,0,0,1,0,2,7,0,10,5,412
10,10,10,10,10,10,0,0,0,0,0,0,0,0,0,0,0,0,0,0,0,0,0,0,0,0,0,0,0,0,0,10,5,413
10,10,10,10,10,10,0,0,0,0,0,0,0,0,0,0,0,0,0,0,0,0,0,0,0,0,0,0,0,0,0,10,5,414
10,10,10,10,10,10,0,0,0,0,0,0,0,0,0,0,0,0,0,0,0,0,0,0,0,0,0,0,0,0,0,10,5,415
10,10,10,10,10,10,0,0,0,0,0,0,0,0,0,0,0,0,0,0,0,0,0,0,0,0,0,0,0,0,0,10,5,416
10,10,10,10,10,2,8,8,8,8,8,2,2,1,1,0,0,0,0,0,0,0,0,0,0,0,1,0,1,6,0,10,6,417
10,10,10,10,10,6,4,4,4,4,4,1,1,1,1,0,0,0,0,0,0,0,0,0,0,0,1,0,0,3,0,10,5,418
10,10,10,10,10,10,0,0,0,0,0,0,0,0,0,0,0,0,0,0,0,0,0,0,0,0,0,0,0,0,0,10,5,419
10,10,10,10,10,8,2,2,2,2,2,1,1,1,1,0,0,0,0,0,0,0,0,0,0,0,1,0,0,1,0,10,5,420
10,10,10,10,10,4,6,6,6,6,6,1,1,1,1,0,0,0,0,0,0,0,0,0,0,0,1,0,0,5,0,10,5,421
10,10,11,10,10,10,1,1,1,1,1,1,1,1,0,0,0,0,0,0,0,0,0,0,0,0,0,1,0,0,0,10,5,422
10,10,14,10,10,10,4,4,4,4,4,4,4,4,0,0,0,0,0,0,0,0,0,0,0,0,0,4,0,0,0,10,5,423
10,10,10,10,10,2,8,9,8,8,8,1,1,1,1,0,0,0,0,0,0,0,0,0,0,0,1,0,1,7,0,10,5,424
10,10,10,10,10,3,7,7,7,7,7,2,2,1,1,0,0,0,0,0,0,0,0,0,0,0,1,0,1,5,0,10,5,425
10,10,10,10,10,10,0,0,0,0,0,0,0,0,0,0,0,0,0,0,0,0,0,0,0,0,0,0,0,0,0,10,5,426
10,10,11,10,10,10,1,1,1,1,1,1,1,1,0,0,0,0,0,0,0,0,0,0,0,0,0,1,0,0,0,10,5,427
10,10,10,10,10,2,8,8,8,8,8,2,2,1,1,0,0,0,0,0,0,0,0,0,0,0,1,0,1,6,0,10,5,428
10,10,10,10,10,3,7,7,7,7,7,2,2,1,1,0,0,0,0,0,0,0,0,0,0,0,1,0,1,5,0,10,5,429
10,10,10,10,10,2,8,9,8,8,8,1,1,1,1,0,0,0,0,0,0,0,0,0,0,0,1,0,1,7,0,10,5,430
10,10,12,10,10,6,6,7,6,6,6,3,3,3,1,0,0,0,0,0,0,0,0,0,0,0,1,2,1,3,0,10,5,431
10,10,10,10,10,2,8,10,8,8,8,2,2,1,1,0,0,0,0,0,0,0,0,0,0,0,1,0,2,7,0,10,5,432
10,10,12,10,10,10,2,2,2,2,2,2,2,2,0,0,0,0,0,0,0,0,0,0,0,0,0,2,0,0,0,10,5,433
10,10,10,10,10,2,8,8,8,8,8,2,2,1,1,0,0,0,0,0,0,0,0,0,0,0,1,0,1,6,0,10,6,434
10,10,10,10,10,2,8,9,8,8,8,1,1,1,1,0,0,0,0,0,0,0,0,0,0,0,1,0,1,7,0,10,5,435
10,10,10,10,10,6,4,4,4,4,4,2,2,1,1,0,0,0,0,0,0,0,0,0,0,0,1,0,1,2,0,10,6,436
10,10,10,10,10,10,0,0,0,0,0,0,0,0,0,0,0,0,0,0,0,0,0,0,0,0,0,0,0,0,0,10,5,437
10,10,10,10,10,3,7,7,7,7,7,2,2,1,1,0,0,0,0,0,0,0,0,0,0,0,1,0,1,5,0,10,6,438
10,10,10,10,10,10,0,0,0,0,0,0,0,0,0,0,0,0,0,0,0,0,0,0,0,0,0,0,0,0,0,10,4,439
10,10,10,10,10,10,0,0,0,0,0,0,0,0,0,0,0,0,0,0,0,0,0,0,0,0,0,0,0,0,0,10,6,440
10,10,11,10,10,10,1,1,1,1,1,1,1,1,0,0,0,0,0,0,0,0,0,0,0,0,0,1,0,0,0,10,6,441
10,10,10,10,10,8,2,2,2,2,2,1,1,1,1,0,0,0,0,0,0,0,0,0,0,0,1,0,0,1,0,10,5,442
10,10,10,10,10,2,8,8,8,8,8,2,2,1,1,0,0,0,0,0,0,0,0,0,0,0,1,0,1,6,0,10,6,443
10,10,10,10,10,2,8,8,8,8,8,2,2,1,1,0,0,0,0,0,0,0,0,0,0,0,1,0,1,6,0,10,6,444
10,10,10,10,10,2,8,8,8,8,8,2,2,1,1,0,0,0,0,0,0,0,0,0,0,0,1,0,1,6,0,10,6,445
10,10,10,10,10,10,0,0,0,0,0,0,0,0,0,0,0,0,0,0,0,0,0,0,0,0,0,0,0,0,0,10,6,446
10,10,10,10,10,2,8,9,8,8,8,2,2,1,1,0,0,0,0,0,0,0,0,0,0,0,1,0,2,6,0,10,6,447
10,10,12,10,10,10,2,2,2,2,2,2,2,2,0,0,0,0,0,0,0,0,0,0,0,0,0,2,0,0,0,10,5,448
10,10,10,10,10,6,4,4,4,4,4,2,2,1,1,0,0,0,0,0,0,0,0,0,0,0,1,0,1,2,0,10,6,449
10,10,10,10,10,2,8,8,8,8,8,1,1,1,1,0,0,0,0,0,0,0,0,0,0,0,1,0,0,7,0,10,5,450
10,10,10,10,10,10,0,0,0,0,0,0,0,0,0,0,0,0,0,0,0,0,0,0,0,0,0,0,0,0,0,10,5,451
10,10,10,10,10,2,8,8,8,8,8,1,1,1,1,0,0,0,0,0,0,0,0,0,0,0,1,0,0,7,0,10,6,452
10,10,10,10,10,2,8,9,8,8,8,1,1,1,1,0,0,0,0,0,0,0,0,0,0,0,1,0,1,7,0,10,5,453
10,10,10,10,10,10,0,0,0,0,0,0,0,0,0,0,0,0,0,0,0,0,0,0,0,0,0,0,0,0,0,10,6,454
10,10,10,10,10,6,4,4,4,4,4,1,1,1,1,0,0,0,0,0,0,0,0,0,0,0,1,0,0,3,0,10,6,455
10,10,10,10,10,2,8,9,8,8,8,1,1,1,1,0,0,0,0,0,0,0,0,0,0,0,1,0,1,7,0,10,6,456
10,10,10,10,10,2,8,8,8,8,8,2,2,1,1,0,0,0,0,0,0,0,0,0,0,0,1,0,1,6,0,10,6,457
10,10,10,10,10,2,8,9,8,8,8,2,2,1,1,0,0,0,0,0,0,0,0,0,0,0,1,0,2,6,0,10,6,458
10,10,10,10,10,10,0,0,0,0,0,0,0,0,0,0,0,0,0,0,0,0,0,0,0,0,0,0,0,0,0,10,6,459
10,10,10,10,10,6,4,4,4,4,4,1,1,1,1,0,0,0,0,0,0,0,0,0,0,0,1,0,0,3,0,10,6,460
10,10,10,10,10,2,8,9,8,8,8,1,1,1,1,0,0,0,0,0,0,0,0,0,0,0,1,0,1,7,0,10,6,461
10,10,10,10,10,2,8,10,8,8,8,2,2,1,1,0,0,0,0,0,0,0,0,0,0,0,1,0,2,7,0,10,5,462
10,10,10,10,10,6,4,5,4,4,4,1,1,1,1,0,0,0,0,0,0,0,0,0,0,0,1,0,1,3,0,10,7,463
10,10,10,10,10,10,0,0,0,0,0,0,0,0,0,0,0,0,0,0,0,0,0,0,0,0,0,0,0,0,0,10,7,464
10,10,10,10,10,10,0,0,0,0,0,0,0,0,0,0,0,0,0,0,0,0,0,0,0,0,0,0,0,0,0,10,6,465
10,10,10,10,10,2,8,9,8,8,8,1,1,1,1,0,0,0,0,0,0,0,0,0,0,0,1,0,1,7,0,10,6,466
10,10,10,10,10,2,8,9,8,8,8,1,1,1,1,0,0,0,0,0,0,0,0,0,0,0,1,0,1,7,0,10,6,467
10,10,10,10,10,6,4,4,4,4,4,1,1,1,1,0,0,0,0,0,0,0,0,0,0,0,1,0,0,3,0,10,6,468
10,10,13,10,10,10,3,3,3,3,3,3,3,3,0,0,0,0,0,0,0,0,0,0,0,0,0,3,0,0,0,10,6,469
10,10,10,10,10,2,8,8,8,8,8,2,2,1,1,0,0,0,0,0,0,0,0,0,0,0,1,0,1,6,0,10,6,470
10,10,10,10,10,3,7,7,7,7,7,2,2,1,1,0,0,0,0,0,0,0,0,0,0,0,1,0,1,5,0,10,6,471
10,10,12,10,10,10,2,2,2,2,2,2,2,2,0,0,0,0,0,0,0,0,0,0,0,0,0,2,0,0,0,10,6,472
10,10,13,10,10,10,3,3,3,3,3,3,3,3,0,0,0,0,0,0,0,0,0,0,0,0,0,3,0,0,0,10,6,473
10,10,10,10,10,10,0,0,0,0,0,0,0,0,0,0,0,0,0,0,0,0,0,0,0,0,0,0,0,0,0,10,4,474
10,10,10,10,10,10,0,0,0,0,0,0,0,0,0,0,0,0,0,0,0,0,0,0,0,0,0,0,0,0,0,10,5,475
10,10,11,10,10,6,5,6,5,5,5,2,2,2,1,0,0,0,0,0,0,0,0,0,0,0,1,1,1,3,0,10,6,476
10,10,10,10,10,2,8,8,8,8,8,2,2,1,1,0,0,0,0,0,0,0,0,0,0,0,1,0,1,6,0,10,7,477
10,10,12,10,10,10,2,2,2,2,2,2,2,2,0,0,0,0,0,0,0,0,0,0,0,0,0,2,0,0,0,10,7,478
10,10,10,10,10,6,4,5,4,4,4,1,1,1,1,0,0,0,0,0,0,0,0,0,0,0,1,0,1,3,0,10,5,479
10,10,11,10,10,10,1,1,1,1,1,1,1,1,0,0,0,0,0,0,0,0,0,0,0,0,0,1,0,0,0,10,5,480
10,10,10,10,10,2,8,9,8,8,8,2,2,1,1,0,0,0,0,0,0,0,0,0,0,0,1,0,2,6,0,10,6,481
10,10,11,10,10,6,5,5,5,5,5,2,2,2,1,0,0,0,0,0,0,0,0,0,0,0,1,1,0,3,0,10,4,482
10,10,10,10,10,2,8,9,8,8,8,1,1,1,1,0,0,0,0,0,0,0,0,0,0,0,1,0,1,7,0,10,6,483
10,10,10,10,10,6,4,4,4,4,4,1,1,1,1,0,0,0,0,0,0,0,0,0,0,0,1,0,0,3,0,10,6,484
10,10,11,10,10,10,1,1,1,1,1,1,1,1,0,0,0,0,0,0,0,0,0,0,0,0,0,1,0,0,0,10,5,485
10,10,11,10,10,10,1,1,1,1,1,1,1,1,0,0,0,0,0,0,0,0,0,0,0,0,0,1,0,0,0,10,6,486
10,10,11,10,10,6,5,5,5,5,5,2,2,2,1,0,0,0,0,0,0,0,0,0,0,0,1,1,0,3,0,10,4,487
10,10,10,10,10,10,0,0,0,0,0,0,0,0,0,0,0,0,0,0,0,0,0,0,0,0,0,0,0,0,0,10,5,488
10,10,10,10,10,2,8,8,8,8,8,1,1,1,1,0,0,0,0,0,0,0,0,0,0,0,1,0,0,7,0,10,5,489
10,10,10,10,10,10,0,0,0,0,0,0,0,0,0,0,0,0,0,0,0,0,0,0,0,0,0,0,0,0,0,10,6,490
10,10,10,10,10,10,0,0,0,0,0,0,0,0,0,0,0,0,0,0,0,0,0,0,0,0,0,0,0,0,0,10,6,491
10,10,10,10,10,2,8,9,8,8,8,2,2,1,1,0,0,0,0,0,0,0,0,0,0,0,1,0,1,7,0,10,5,492
10,10,10,10,10,10,0,0,0,0,0,0,0,0,0,0,0,0,0,0,0,0,0,0,0,0,0,0,0,0,0,10,4,493
10,10,10,10,10,2,8,10,8,8,8,2,2,1,1,0,0,0,0,0,0,0,0,0,0,0,1,0,2,7,0,10,6,494
10,10,10,10,10,10,0,0,0,0,0,0,0,0,0,0,0,0,0,0,0,0,0,0,0,0,0,0,0,0,0,10,5,495
10,10,10,10,10,2,8,8,8,8,8,1,1,1,1,0,0,0,0,0,0,0,0,0,0,0,1,0,0,7,0,10,5,496
10,10,10,10,10,10,0,0,0,0,0,0,0,0,0,0,0,0,0,0,0,0,0,0,0,0,0,0,0,0,0,10,5,497
10,10,10,10,10,2,8,8,8,8,8,2,2,1,1,0,0,0,0,0,0,0,0,0,0,0,1,0,1,6,0,10,5,498
10,10,10,10,10,5,5,6,5,5,5,1,1,1,1,0,0,0,0,0,0,0,0,0,0,0,1,0,1,4,0,10,6,499
10,10,10,10,10,10,0,0,0,0,0,0,0,0,0,0,0,0,0,0,0,0,0,0,0,0,0,0,0,0,0,10,6,500
10,10,11,10,10,10,1,1,1,1,1,1,1,1,0,0,0,0,0,0,0,0,0,0,0,0,0,1,0,0,0,10,6,501
10,10,10,10,10,2,8,8,8,8,8,1,1,1,1,0,0,0,0,0,0,0,0,0,0,0,1,0,0,7,0,10,5,502
10,10,10,10,10,10,0,0,0,0,0,0,0,0,0,0,0,0,0,0,0,0,0,0,0,0,0,0,0,0,0,10,6,503
10,10,12,10,10,10,2,2,2,2,2,2,2,2,0,0,0,0,0,0,0,0,0,0,0,0,0,2,0,0,0,10,7,504
10,10,10,10,10,2,8,9,8,8,8,2,2,1,1,0,0,0,0,0,0,0,0,0,0,0,1,0,2,6,0,10,6,505
10,10,11,10,10,10,1,1,1,1,1,1,1,1,0,0,0,0,0,0,0,0,0,0,0,0,0,1,0,0,0,10,5,506
10,10,10,10,10,2,8,9,8,8,8,1,1,1,1,0,0,0,0,0,0,0,0,0,0,0,1,0,1,7,0,10,4,507
10,10,10,10,10,2,8,9,8,8,8,1,1,1,1,0,0,0,0,0,0,0,0,0,0,0,1,0,1,7,0,10,5,508
10,10,10,10,10,2,8,10,8,8,8,2,2,1,1,0,0,0,0,0,0,0,0,0,0,0,1,0,2,7,0,10,6,509
10,10,10,10,10,7,3,3,3,3,3,2,2,2,1,0,0,0,0,0,0,0,0,0,0,0,1,1,0,1,0,10,4,510
10,10,10,10,10,2,8,9,8,8,8,1,1,1,1,0,0,0,0,0,0,0,0,0,0,0,1,0,1,7,0,10,5,511
20,20,20,20,20,2,18,18,18,18,18,1,1,1,1,0,0,0,0,0,0,0,0,0,0,0,1,0,0,17,0,20,6,129
20,20,20,20,20,4,16,16,16,16,16,1,1,1,1,0,0,0,0,0,0,0,0,0,0,0,1,0,0,15,0,20,6,130
20,20,29,20,20,20,9,9,9,9,9,9,9,9,0,0,0,0,0,0,0,0,0,0,0,0,0,9,0,0,0,20,6,131
20,20,20,20,20,2,18,19,18,18,18,1,1,1,1,0,0,0,0,0,0,0,0,0,0,0,1,0,1,17,0,20,6,132
20,20,20,20,20,20,0,0,0,0,0,0,0,0,0,0,0,0,0,0,0,0,0,0,0,0,0,0,0,0,0,20,6,133
20,20,20,20,20,4,16,16,16,16,16,2,2,1,1,0,0,0,0,0,0,0,0,0,0,0,1,0,1,14,0,20,6,134
20,20,20,20,20,20,0,0,0,0,0,0,0,0,0,0,0,0,0,0,0,0,0,0,0,0,0,0,0,0,0,20,6,135
20,20,20,20,20,17,3,3,3,3,3,1,1,1,1,0,0,0,0,0,0,0,0,0,0,0,1,0,0,2,0,20,6,136
20,20,20,20,20,20,0,0,0,0,0,0,0,0,0,0,0,0,0,0,0,0,0,0,0,0,0,0,0,0,0,20,6,137
20,20,21,20,20,18,3,3,3,3,3,2,2,2,1,0,0,0,0,0,0,0,0,0,0,0,1,1,0,1,0,20,6,138
20,20,22,20,20,4,18,18,18,18,18,4,4,3,1,0,0,0,0,0,0,0,0,0,0,0,1,2,1,14,0,20,6,139
20,20,21,20,20,20,1,1,1,1,1,1,1,1,0,0,0,0,0,0,0,0,0,0,0,0,0,1,0,0,0,20,6,140
20,20,26,20,20,12,14,14,14,14,14,7,7,7,1,0,0,0,0,0,0,0,0,0,0,0,1,6,0,7,0,20,6,141
20,20,20,20,20,20,0,0,0,0,0,0,0,0,0,0,0,0,0,0,0,0,0,0,0,0,0,0,0,0,0,20,6,142
20,20,20,20,20,2,18,19,18,18,18,1,1,1,1,0,0,0,0,0,0,0,0,0,0,0,1,0,1,17,0,20,6,143
20,20,20,20,20,20,0,0,0,0,0,0,0,0,0,0,0,0,0,0,0,0,0,0,0,0,0,0,0,0,0,20,6,144
20,20,20,20,20,2,18,18,18,18,18,1,1,1,1,0,0,0,0,0,0,0,0,0,0,0,1,0,0,17,0,20,6,145
20,20,20,20,20,2,18,18,18,18,18,1,1,1,1,0,0,0,0,0,0,0,0,0,0,0,1,0,0,17,0,20,6,146
20,20,20,20,20,20,0,0,0,0,0,0,0,0,0,0,0,0,0,0,0,0,0,0,0,0,0,0,0,0,0,20,6,147
20,20,20,20,20,20,0,0,0,0,0,0,0,0,0,0,0,0,0,0,0,0,0,0,0,0,0,0,0,0,0,20,6,148
20,20,20,20,20,6,14,14,14,14,14,1,1,1,1,0,0,0,0,0,0,0,0,0,0,0,1,0,0,13,0,20,6,149
20,20,20,20,20,4,16,16,16,16,16,2,2,1,1,0,0,0,0,0,0,0,0,0,0,0,1,0,1,14,0,20,6,150
20,20,20,20,20,20,0,0,0,0,0,0,0,0,0,0,0,0,0,0,0,0,0,0,0,0,0,0,0,0,0,20,6,151
20,20,20,20,20,20,0,0,0,0,0,0,0,0,0,0,0,0,0,0,0,0,0,0,0,0,0,0,0,0,0,20,6,152
20,20,20,20,20,6,14,14,14,14,14,2,2,1,1,0,0,0,0,0,0,0,0,0,0,0,1,0,1,12,0,20,6,153
20,20,23,20,20,10,13,14,13,13,13,4,4,4,1,0,0,0,0,0,0,0,0,0,0,0,1,3,1,9,0,20,6,154
20,20,22,20,20,20,2,2,2,2,2,2,2,2,0,0,0,0,0,0,0,0,0,0,0,0,0,2,0,0,0,20,6,155
20,20,20,20,20,6,14,14,14,14,14,2,2,1,1,0,0,0,0,0,0,0,0,0,0,0,1,0,1,12,0,20,6,156
20,20,20,20,20,2,18,18,18,18,18,1,1,1,1,0,0,0,0,0,0,0,0,0,0,0,1,0,0,17,0,20,6,157
20,20,20,20,20,4,16,16,16,16,16,2,2,1,1,0,0,0,0,0,0,0,0,0,0,0,1,0,1,14,0,20,6,158
20,20,20,20,20,20,0,0,0,0,0,0,0,0,0,0,0,0,0,0,0,0,0,0,0,0,0,0,0,0,0,20,6,159
20,20,31,20,20,20,11,11,11,11,11,11,11,11,0,0,0,0,0,0,0,0,0,0,0,0,0,11,0,0,0,20,6,160
20,20,20,20,20,2,18,19,18,18,18,1,1,1,1,0,0,0,0,0,0,0,0,0,0,0,1,0,1,17,0,20,6,161
20,1,1,1,1,1,0,0,0,0,0,0,0,0,0,0,0,0,0,0,0,0,0,0,0,0,0,0,0,0,0,20,5,162
20,1,1,1,1,1,0,0,0,0,0,0,0,0,0,0,0,0,0,0,0,0,0,0,0,0,0,0,0,0,0,20,4,163
20,18,19,18,18,18,1,1,1,1,1,1,1,1,0,0,0,0,0,0,0,0,0,0,0,0,0,1,0,0,0,20,7,164
20,18,19,18,18,16,3,3,3,3,3,2,2,2,1,0,0,0,0,0,0,0,0,0,0,0,1,1,0,1,0,20,6,165
20,3,3,3,3,3,0,0,0,0,0,0,0,0,0,0,0,0,0,0,0,0,0,0,0,0,0,0,0,0,0,20,5,166
20,3,3,3,3,3,0,0,0,0,0,0,0,0,0,0,0,0,0,0,0,0,0,0,0,0,0,0,0,0,0,20,5,167
20,16,16,16,16,16,0,0,0,0,0,0,0,0,0,0,0,0,0,0,0,0,0,0,0,0,0,0,0,0,0,20,5,168
20,16,16,16,16,1,15,16,15,15,15,1,1,0,0,0,0,0,0,0,0,0,0,0,0,0,0,0,1,15,0,20,5,169
20,5,5,5,5,3,2,2,2,2,2,0,0,0,0,0,0,0,0,0,0,0,0,0,0,0,0,0,0,2,0,20,5,170
20,5,5,5,5,1,4,4,4,4,4,0,0,0,0,0,0,0,0,0,0,0,0,0,0,0,0,0,0,4,0,20,5,171
20,14,14,14,14,4,10,10,10,10,10,1,1,1,1,0,0,0,0,0,0,0,0,0,0,0,1,0,0,9,0,20,5,172
20,14,14,14,14,1,13,13,13,13,13,0,0,0,0,0,0,0,0,0,0,0,0,0,0,0,0,0,0,13,0,20,5,173
20,7,7,7,7,1,6,7,6,6,6,1,1,0,0,0,0,0,0,0,0,0,0,0,0,0,0,0,1,6,0,20,5,174
20,7,8,7,7,7,1,1,1,1,1,1,1,1,0,0,0,0,0,0,0,0,0,0,0,0,0,1,0,0,0,20,5,175
20,12,12,12,12,1,11,11,11,11,11,1,1,0,0,0,0,0,0,0,0,0,0,0,0,0,0,0,1,10,0,20,5,176
20,12,12,12,12,1,11,12,11,11,11,1,1,0,0,0,0,0,0,0,0,0,0,0,0,0,0,0,1,11,0,20,5,177
20,9,9,9,9,4,5,5,5,5,5,1,1,1,1,0,0,0,0,0,0,0,0,0,0,0,1,0,0,4,0,20,5,178
20,9,10,9,9,2,8,8,8,8,8,2,2,2,1,0,0,0,0,0,0,0,0,0,0,0,1,1,0,6,0,20,5,179
20,10,10,10,10,3,7,7,7,7,7,0,0,0,0,0,0,0,0,0,0,0,0,0,0,0,0,0,0,7,0,20,5,180
20,10,12,10,10,10,2,2,2,2,2,2,2,2,0,0,0,0,0,0,0,0,0,0,0,0,0,2,0,0,0,20,5,181
20,10,10,10,10,3,7,7,7,7,7,0,0,0,0,0,0,0,0,0,0,0,0,0,0,0,0,0,0,7,0,20,5,182
20,10,10,10,10,10,0,0,0,0,0,0,0,0,0,0,0,0,0,0,0,0,0,0,0,0,0,0,0,0,0,20,5,183
20,10,10,10,10,3,7,7,7,7,7,0,0,0,0,0,0,0,0,0,0,0,0,0,0,0,0,0,0,7,0,20,5,184
20,10,10,10,10,1,9,9,9,9,9,1,1,0,0,0,0,0,0,0,0,0,0,0,0,0,0,0,1,8,0,20,5,185
20,10,10,10,10,10,0,0,0,0,0,0,0,0,0,0,0,0,0,0,0,0,0,0,0,0,0,0,0,0,0,20,5,186
20,10,10,10,10,2,8,8,8,8,8,1,1,1,1,0,0,0,0,0,0,0,0,0,0,0,1,0,0,7,0,20,5,187
20,10,10,10,10,3,7,7,7,7,7,0,0,0,0,0,0,0,0,0,0,0,0,0,0,0,0,0,0,7,0,20,5,188
20,10,11,10,10,2,9,9,9,9,9,2,2,2,1,0,0,0,0,0,0,0,0,0,0,0,1,1,0,7,0,20,5,189
20,10,10,10,10,10,0,0,0,0,0,0,0,0,0,0,0,0,0,0,0,0,0,0,0,0,0,0,0,0,0,20,5,190
20,10,10,10,10,10,0,0,0,0,0,0,0,0,0,0,0,0,0,0,0,0,0,0,0,0,0,0,0,0,0,20,5,191
20,10,10,10,10,1,9,10,9,9,9,2,1,0,0,0,0,0,0,0,0,0,0,0,0,0,0,0,2,8,0,20,5,192
20,15,15,15,15,1,14,14,14,14,14,2,2,1,1,0,0,0,0,0,0,0,0,0,0,0,1,0,1,12,0,20,5,193
20,15,15,15,15,4,11,11,11,11,11,1,1,1,1,0,0,0,0,0,0,0,0,0,0,0,1,0,0,10,0,20,5,194
20,15,15,15,15,3,12,12,12,12,12,2,2,2,1,0,0,0,0,0,0,0,0,0,0,0,1,1,0,10,0,20,5,195
20,15,15,15,15,2,13,13,13,13,13,2,2,1,1,0,0,0,0,0,0,0,0,0,0,0,1,0,1,11,0,20,5,196
20,15,15,15,15,1,14,16,14,14,14,2,2,1,1,0,0,0,0,0,0,0,0,0,0,0,1,0,2,13,0,20,5,197
20,15,19,15,15,15,4,4,4,4,4,4,4,4,0,0,0,0,0,0,0,0,0,0,0,0,0,4,0,0,0,20,5,198
20,15,22,15,15,15,7,7,7,7,7,7,7,7,0,0,0,0,0,0,0,0,0,0,0,0,0,7,0,0,0,20,5,199
20,15,15,15,15,1,14,15,14,14,14,2,2,1,1,0,0,0,0,0,0,0,0,0,0,0,1,0,2,12,0,20,5,200
20,15,15,15,15,1,14,14,14,14,14,2,2,1,1,0,0,0,0,0,0,0,0,0,0,0,1,0,1,12,0,20,5,201
20,15,15,15,15,15,0,0,0,0,0,0,0,0,0,0,0,0,0,0,0,0,0,0,0,0,0,0,0,0,0,20,5,202
20,15,16,15,15,4,12,12,12,12,12,3,3,2,1,0,0,0,0,0,0,0,0,0,0,0,1,1,1,9,0,20,5,203
20,15,15,15,15,7,8,8,8,8,8,2,2,1,1,0,0,0,0,0,0,0,0,0,0,0,1,0,1,6,0,20,5,204
20,15,15,15,15,1,14,15,14,14,14,2,2,1,1,0,0,0,0,0,0,0,0,0,0,0,1,0,2,12,0,20,5,205
20,15,15,15,15,1,14,15,14,14,14,2,2,1,1,0,0,0,0,0,0,0,0,0,0,0,1,0,2,12,0,20,5,206
20,15,15,15,15,15,0,0,0,0,0,0,0,0,0,0,0,0,0,0,0,0,0,0,0,0,0,0,0,0,0,20,5,207
20,15,15,15,15,15,0,0,0,0,0,0,0,0,0,0,0,0,0,0,0,0,0,0,0,0,0,0,0,0,0,20,5,208
20,15,15,15,15,4,11,11,11,11,11,1,1,1,1,0,0,0,0,0,0,0,0,0,0,0,1,0,0,10,0,20,5,209
20,15,15,15,15,6,9,9,9,9,9,1,1,1,1,0,0,0,0,0,0,0,0,0,0,0,1,0,0,8,0,20,5,210
20,15,16,15,15,15,1,1,1,1,1,1,1,1,0,0,0,0,0,0,0,0,0,0,0,0,0,1,0,0,0,20,5,211
20,15,15,15,15,1,14,15,14,14,14,1,1,1,1,0,0,0,0,0,0,0,0,0,0,0,1,0,1,13,0,20,5,212
20,15,15,15,15,15,0,0,0,0,0,0,0,0,0,0,0,0,0,0,0,0,0,0,0,0,0,0,0,0,0,20,5,213
20,15,15,15,15,1,14,14,14,14,14,2,2,1,1,0,0,0,0,0,0,0,0,0,0,0,1,0,1,12,0,20,5,214
20,15,15,15,15,1,14,15,14,14,14,1,1,1,1,0,0,0,0,0,0,0,0,0,0,0,1,0,1,13,0,20,5,215
20,15,15,15,15,1,14,15,14,14,14,2,2,1,1,0,0,0,0,0,0,0,0,0,0,0,1,0,2,12,0,20,5,216
20,15,15,15,15,1,14,15,14,14,14,2,2,1,1,0,0,0,0,0,0,0,0,0,0,0,1,0,2,12,0,20,5,217
20,15,15,15,15,4,11,11,11,11,11,2,2,1,1,0,0,0,0,0,0,0,0,0,0,0,1,0,1,9,0,20,5,218
20,15,15,15,15,2,13,13,13,13,13,2,2,1,1,0,0,0,0,0,0,0,0,0,0,0,1,0,1,11,0,20,5,219
20,15,15,15,15,15,0,0,0,0,0,0,0,0,0,0,0,0,0,0,0,0,0,0,0,0,0,0,0,0,0,20,5,220
20,15,16,15,15,6,10,10,10,10,10,2,2,2,1,0,0,0,0,0,0,0,0,0,0,0,1,1,0,8,0,20,5,221
20,15,15,15,15,1,14,14,14,14,14,2,2,1,1,0,0,0,0,0,0,0,0,0,0,0,1,0,1,12,0,20,5,222
20,15,19,15,15,15,4,4,4,4,4,4,4,4,0,0,0,0,0,0,0,0,0,0,0,0,0,4,0,0,0,20,5,223
20,15,19,15,15,15,4,4,4,4,4,4,4,4,0,0,0,0,0,0,0,0,0,0,0,0,0,4,0,0,0,20,5,224
20,20,20,20,20,2,18,18,18,18,18,1,1,1,1,0,0,0,0,0,0,0,0,0,0,0,1,0,0,17,0,20,5,225
20,20,20,20,20,2,18,18,18,18,18,1,1,1,1,0,0,0,0,0,0,0,0,0,0,0,1,0,0,17,0,20,6,226
20,20,20,20,20,20,0,0,0,0,0,0,0,0,0,0,0,0,0,0,0,0,0,0,0,0,0,0,0,0,0,20,5,227
20,20,20,20,20,2,18,19,18,18,18,1,1,1,1,0,0,0,0,0,0,0,0,0,0,0,1,0,1,17,0,20,6,228
20,20,20,20,20,2,18,20,18,18,18,2,2,1,1,0,0,0,0,0,0,0,0,0,0,0,1,0,2,17,0,20,5,229
20,20,20,20,20,6,14,14,14,14,14,1,1,1,1,0,0,0,0,0,0,0,0,0,0,0,1,0,0,13,0,20,6,230
20,20,20,20,20,2,18,20,18,18,18,2,2,1,1,0,0,0,0,0,0,0,0,0,0,0,1,0,2,17,0,20,5,231
20,20,20,20,20,20,0,0,0,0,0,0,0,0,0,0,0,0,0,0,0,0,0,0,0,0,0,0,0,0,0,20,5,232
20,20,20,20,20,2,18,19,18,18,18,1,1,1,1,0,0,0,0,0,0,0,0,0,0,0,1,0,1,17,0,20,5,233
20,20,22,20,20,6,16,16,16,16,16,3,3,3,1,0,0,0,0,0,0,0,0,0,0,0,1,2,0,13,0,20,5,234
20,20,20,20,20,2,18,18,18,18,18,2,2,1,1,0,0,0,0,0,0,0,0,0,0,0,1,0,1,16,0,20,5,235
20,20,23,20,20,20,3,3,3,3,3,3,3,3,0,0,0,0,0,0,0,0,0,0,0,0,0,3,0,0,0,20,5,236
20,20,20,20,20,20,0,0,0,0,0,0,0,0,0,0,0,0,0,0,0,0,0,0,0,0,0,0,0,0,0,20,5,237
20,20,22,20,20,6,16,17,16,16,16,3,3,3,1,0,0,0,0,0,0,0,0,0,0,0,1,2,1,13,0,20,5,238
20,20,24,20,20,20,4,4,4,4,4,4,4,4,0,0,0,0,0,0,0,0,0,0,0,0,0,4,0,0,0,20,5,239
20,20,30,20,20,20,10,10,10,10,10,10,10,10,0,0,0,0,0,0,0,0,0,0,0,0,0,10,0,0,0,20,5,240
20,20,20,20,20,5,15,15,15,15,15,2,2,2,1,0,0,0,0,0,0,0,0,0,0,0,1,1,0,13,0,20,5,241
20,20,21,20,20,6,15,15,15,15,15,2,2,2,1,0,0,0,0,0,0,0,0,0,0,0,1,1,0,13,0,20,5,242
20,20,21,20,20,20,1,1,1,1,1,1,1,1,0,0,0,0,0,0,0,0,0,0,0,0,0,1,0,0,0,20,5,243
20,20,21,20,20,20,1,1,1,1,1,1,1,1,0,0,0,0,0,0,0,0,0,0,0,0,0,1,0,0,0,20,5,244
20,20,21,20,20,20,1,1,1,1,1,1,1,1,0,0,0,0,0,0,0,0,0,0,0,0,0,1,0,0,0,20,5,245
20,20,20,20,20,2,18,19,18,18,18,2,2,1,1,0,0,0,0,0,0,0,0,0,0,0,1,0,2,16,0,20,5,246
20,20,20,20,20,2,18,20,18,18,18,2,2,1,1,0,0,0,0,0,0,0,0,0,0,0,1,0,2,17,0,20,5,247
20,20,20,20,20,2,18,19,18,18,18,1,1,1,1,0,0,0,0,0,0,0,0,0,0,0,1,0,1,17,0,20,5,248
20,20,20,20,20,2,18,18,18,18,18,2,2,1,1,0,0,0,0,0,0,0,0,0,0,0,1,0,1,16,0,20,5,249
20,20,20,20,20,20,0,0,0,0,0,0,0,0,0,0,0,0,0,0,0,0,0,0,0,0,0,0,0,0,0,20,5,250
20,20,20,20,20,2,18,18,18,18,18,1,1,1,1,0,0,0,0,0,0,0,0,0,0,0,1,0,0,17,0,20,5,251
20,20,27,20,20,20,7,7,7,7,7,7,7,7,0,0,0,0,0,0,0,0,0,0,0,0,0,7,0,0,0,20,5,252
20,20,21,20,20,14,7,7,7,7,7,2,2,2,1,0,0,0,0,0,0,0,0,0,0,0,1,1,0,5,0,20,5,253
20,20,20,20,20,2,18,19,18,18,18,1,1,1,1,0,0,0,0,0,0,0,0,0,0,0,1,0,1,17,0,20,5,254
20,20,20,20,20,7,13,13,13,13,13,2,2,2,1,0,0,0,0,0,0,0,0,0,0,0,1,1,0,11,0,20,5,255
20,20,20,20,20,2,18,18,18,18,18,1,0,0,0,0,0,0,0,0,0,0,0,0,0,0,0,0,1,17,0,20,5,256
20,20,20,20,20,4,16,16,16,16,16,1,1,1,1,0,0,0,0,0,0,0,0,0,0,0,1,0,0,15,0,20,5,257
20,20,20,20,20,2,18,19,18,18,18,1,1,1,1,0,0,0,0,0,0,0,0,0,0,0,1,0,1,17,0,20,5,258
20,20,21,20,20,6,15,17,15,15,15,3,3,2,1,0,0,0,0,0,0,0,0,0,0,0,1,1,2,13,0,20,5,259
20,20,20,20,20,4,16,16,16,16,16,1,1,1,1,0,0,0,0,0,0,0,0,0,0,0,1,0,0,15,0,20,5,260
20,20,21,20,20,6,15,16,15,15,15,2,2,2,1,0,0,0,0,0,0,0,0,0,0,0,1,1,1,13,0,20,5,261
20,20,24,20,20,20,4,4,4,4,4,4,4,4,0,0,0,0,0,0,0,0,0,0,0,0,0,4,0,0,0,20,5,262
20,20,20,20,20,20,0,0,0,0,0,0,0,0,0,0,0,0,0,0,0,0,0,0,0,0,0,0,0,0,0,20,5,263
20,20,20,20,20,2,18,19,18,18,18,1,1,1,1,0,0,0,0,0,0,0,0,0,0,0,1,0,1,17,0,20,5,264
20,20,20,20,20,2,18,19,18,18,18,1,1,1,1,0,0,0,0,0,0,0,0,0,0,0,1,0,1,17,0,20,5,265
20,20,22,20,20,20,2,2,2,2,2,2,2,2,0,0,0,0,0,0,0,0,0,0,0,0,0,2,0,0,0,20,5,266
20,20,22,20,20,16,6,6,6,6,6,3,3,3,1,0,0,0,0,0,0,0,0,0,0,0,1,2,0,3,0,20,5,267
20,20,20,20,20,4,16,16,16,16,16,2,2,1,1,0,0,0,0,0,0,0,0,0,0,0,1,0,1,14,0,20,5,268
20,20,21,20,20,5,16,17,16,16,16,2,2,2,1,0,0,0,0,0,0,0,0,0,0,0,1,1,1,14,0,20,5,269
20,20,20,20,20,20,0,0,0,0,0,0,0,0,0,0,0,0,0,0,0,0,0,0,0,0,0,0,0,0,0,20,5,270
20,20,20,20,20,20,0,0,0,0,0,0,0,0,0,0,0,0,0,0,0,0,0,0,0,0,0,0,0,0,0,20,5,271
20,20,21,20,20,17,4,4,4,4,4,2,2,2,1,0,0,0,0,0,0,0,0,0,0,0,1,1,0,2,0,20,5,272
20,20,20,20,20,6,14,14,14,14,14,1,1,1,1,0,0,0,0,0,0,0,0,0,0,0,1,0,0,13,0,20,5,273
20,20,24,20,20,20,4,4,4,4,4,4,4,4,0,0,0,0,0,0,0,0,0,0,0,0,0,4,0,0,0,20,5,274
20,20,22,20,20,20,2,2,2,2,2,2,2,2,0,0,0,0,0,0,0,0,0,0,0,0,0,2,0,0,0,20,5,275
20,20,21,20,20,18,3,3,3,3,3,2,2,2,1,0,0,0,0,0,0,0,0,0,0,0,1,1,0,1,0,20,5,276
20,20,20,20,20,20,0,0,0,0,0,0,0,0,0,0,0,0,0,0,0,0,0,0,0,0,0,0,0,0,0,20,5,277
20,20,21,20,20,4,17,18,17,17,17,3,3,2,1,0,0,0,0,0,0,0,0,0,0,0,1,1,1,15,0,20,5,278
20,20,24,20,20,20,4,4,4,4,4,4,4,4,0,0,0,0,0,0,0,0,0,0,0,0,0,4,0,0,0,20,5,279
20,20,21,20,20,20,1,1,1,1,1,1,1,1,0,0,0,0,0,0,0,0,0,0,0,0,0,1,0,0,0,20,6,280
20,20,21,20,20,20,1,1,1,1,1,1,1,1,0,0,0,0,0,0,0,0,0,0,0,0,0,1,0,0,0,20,5,281
20,20,23,20,20,12,11,11,11,11,11,4,4,4,1,0,0,0,0,0,0,0,0,0,0,0,1,3,0,7,0,20,5,282
20,20,22,20,20,20,2,2,2,2,2,2,2,2,0,0,0,0,0,0,0,0,0,0,0,0,0,2,0,0,0,20,5,283
20,20,21,20,20,20,1,1,1,1,1,1,1,1,0,0,0,0,0,0,0,0,0,0,0,0,0,1,0,0,0,20,6,284
20,20,23,20,20,10,13,13,13,13,13,4,4,4,1,0,0,0,0,0,0,0,0,0,0,0,1,3,0,9,0,20,5,285
20,20,20,20,20,2,18,19,18,18,18,1,1,1,1,0,0,0,0,0,0,0,0,0,0,0,1,0,1,17,0,20,5,286
20,20,22,20,20,20,2,2,2,2,2,2,2,2,0,0,0,0,0,0,0,0,0,0,0,0,0,2,0,0,0,20,6,287
20,20,29,20,20,20,9,9,9,9,9,9,9,9,0,0,0,0,0,0,0,0,0,0,0,0,0,9,0,0,0,20,5,288
20,20,22,20,20,20,2,2,2,2,2,2,2,2,0,0,0,0,0,0,0,0,0,0,0,0,0,2,0,0,0,20,5,289
20,20,20,20,20,2,18,18,18,18,18,1,1,1,1,0,0,0,0,0,0,0,0,0,0,0,1,0,0,17,0,20,6,290
20,20,20,20,20,20,0,0,0,0,0,0,0,0,0,0,0,0,0,0,0,0,0,0,0,0,0,0,0,0,0,20,5,291
20,20,20,20,20,2,18,19,18,18,18,1,1,1,1,0,0,0,0,0,0,0,0,0,0,0,1,0,1,17,0,20,6,292
20,20,21,20,20,20,1,1,1,1,1,1,1,1,0,0,0,0,0,0,0,0,0,0,0,0,0,1,0,0,0,20,5,293
20,20,20,20,20,20,0,0,0,0,0,0,0,0,0,0,0,0,0,0,0,0,0,0,0,0,0,0,0,0,0,20,6,294
20,20,20,20,20,20,0,0,0,0,0,0,0,0,0,0,0,0,0,0,0,0,0,0,0,0,0,0,0,0,0,20,6,295
20,20,20,20,20,20,0,0,0,0,0,0,0,0,0,0,0,0,0,0,0,0,0,0,0,0,0,0,0,0,0,20,6,296
20,20,20,20,20,20,0,0,0,0,0,0,0,0,0,0,0,0,0,0,0,0,0,0,0,0,0,0,0,0,0,20,6,297
20,20,20,20,20,6,14,14,14,14,14,1,1,1,1,0,0,0,0,0,0,0,0,0,0,0,1,0,0,13,0,20,6,298
20,20,20,20,20,20,0,0,0,0,0,0,0,0,0,0,0,0,0,0,0,0,0,0,0,0,0,0,0,0,0,20,6,299
20,20,20,20,20,4,16,16,16,16,16,2,2,1,1,0,0,0,0,0,0,0,0,0,0,0,1,0,1,14,0,20,6,300
20,20,20,20,20,4,16,17,16,16,16,1,1,1,1,0,0,0,0,0,0,0,0,0,0,0,1,0,1,15,0,20,6,301
20,20,20,20,20,20,0,0,0,0,0,0,0,0,0,0,0,0,0,0,0,0,0,0,0,0,0,0,0,0,0,20,6,302
20,20,24,20,20,10,14,14,14,14,14,5,5,5,1,0,0,0,0,0,0,0,0,0,0,0,1,4,0,9,0,20,6,303
20,20,20,20,20,20,0,0,0,0,0,0,0,0,0,0,0,0,0,0,0,0,0,0,0,0,0,0,0,0,0,20,4,304
20,20,22,20,20,20,2,2,2,2,2,2,2,2,0,0,0,0,0,0,0,0,0,0,0,0,0,2,0,0,0,20,6,305
20,20,20,20,20,6,14,14,14,14,14,2,2,1,1,0,0,0,0,0,0,0,0,0,0,0,1,0,1,12,0,20,6,306
20,20,21,20,20,20,1,1,1,1,1,1,1,1,0,0,0,0,0,0,0,0,0,0,0,0,0,1,0,0,0,20,6,307
20,20,21,20,20,10,11,12,11,11,11,2,2,2,1,0,0,0,0,0,0,0,0,0,0,0,1,1,1,9,0,20,6,308
20,20,20,20,20,20,0,0,0,0,0,0,0,0,0,0,0,0,0,0,0,0,0,0,0,0,0,0,0,0,0,20,6,309
20,20,20,20,20,20,0,0,0,0,0,0,0,0,0,0,0,0,0,0,0,0,0,0,0,0,0,0,0,0,0,20,6,310
20,20,20,20,20,2,18,19,18,18,18,1,1,1,1,0,0,0,0,0,0,0,0,0,0,0,1,0,1,17,0,20,6,311
20,20,20,20,20,6,14,14,14,14,14,2,2,1,1,0,0,0,0,0,0,0,0,0,0,0,1,0,1,12,0,20,6,312
20,20,20,20,20,20,0,0,0,0,0,0,0,0,0,0,0,0,0,0,0,0,0,0,0,0,0,0,0,0,0,20,6,313
20,20,20,20,20,2,18,18,18,18,18,1,1,1,1,0,0,0,0,0,0,0,0,0,0,0,1,0,0,17,0,20,6,314
20,20,20,20,20,6,14,14,14,14,14,2,2,1,1,0,0,0,0,0,0,0,0,0,0,0,1,0,1,12,0,20,6,315
20,20,20,20,20,4,16,16,16,16,16,2,2,1,1,0,0,0,0,0,0,0,0,0,0,0,1,0,1,14,0,20,6,316
20,20,20,20,20,20,0,0,0,0,0,0,0,0,0,0,0,0,0,0,0,0,0,0,0,0,0,0,0,0,0,20,6,317
20,20,20,20,20,20,0,0,0,0,0,0,0,0,0,0,0,0,0,0,0,0,0,0,0,0,0,0,0,0,0,20,6,318
20,20,20,20,20,20,0,0,0,0,0,0,0,0,0,0,0,0,0,0,0,0,0,0,0,0,0,0,0,0,0,20,6,319
20,20,28,20,20,20,8,8,8,8,8,8,8,8,0,0,0,0,0,0,0,0,0,0,0,0,0,8,0,0,0,20,6,320
20,20,21,20,20,20,1,1,1,1,1,1,1,1,0,0,0,0,0,0,0,0,0,0,0,0,0,1,0,0,0,20,6,321
20,20,20,20,20,2,18,19,18,18,18,1,1,1,1,0,0,0,0,0,0,0,0,0,0,0,1,0,1,17,0,20,7,322
20,20,20,20,20,2,18,19,18,18,18,1,1,1,1,0,0,0,0,0,0,0,0,0,0,0,1,0,1,17,0,20,4,323
20,20,20,20,20,2,18,18,18,18,18,1,1,1,1,0,0,0,0,0,0,0,0,0,0,0,1,0,0,17,0,20,5,324
20,20,20,20,20,2,18,20,18,18,18,2,2,1,1,0,0,0,0,0,0,0,0,0,0,0,1,0,2,17,0,20,6,325
20,20,20,20,20,20,0,0,0,0,0,0,0,0,0,0,0,0,0,0,0,0,0,0,0,0,0,0,0,0,0,20,6,326
20,20,20,20,20,20,0,0,0,0,0,0,0,0,0,0,0,0,0,0,0,0,0,0,0,0,0,0,0,0,0,20,6,327
20,20,23,20,20,20,3,3,3,3,3,3,3,3,0,0,0,0,0,0,0,0,0,0,0,0,0,3,0,0,0,20,6,328
20,20,20,20,20,2,18,18,18,18,18,2,2,1,1,0,0,0,0,0,0,0,0,0,0,0,1,0,1,16,0,20,6,329
20,20,20,20,20,18,2,2,2,2,2,1,1,1,1,0,0,0,0,0,0,0,0,0,0,0,1,0,0,1,0,20,6,330
20,20,20,20,20,2,18,20,18,18,18,2,2,1,1,0,0,0,0,0,0,0,0,0,0,0,1,0,2,17,0,20,7,331
20,20,22,20,20,20,2,2,2,2,2,2,2,2,0,0,0,0,0,0,0,0,0,0,0,0,0,2,0,0,0,20,6,332
20,20,20,20,20,2,18,19,18,18,18,1,1,1,1,0,0,0,0,0,0,0,0,0,0,0,1,0,1,17,0,20,6,333
20,20,21,20,20,20,1,1,1,1,1,1,1,1,0,0,0,0,0,0,0,0,0,0,0,0,0,1,0,0,0,20,6,334
20,20,20,20,20,20,0,0,0,0,0,0,0,0,0,0,0,0,0,0,0,0,0,0,0,0,0,0,0,0,0,20,6,335
20,20,22,20,20,20,2,2,2,2,2,2,2,2,0,0,0,0,0,0,0,0,0,0,0,0,0,2,0,0,0,20,6,336
20,20,25,20,20,16,9,10,9,9,9,7,7,6,1,0,0,0,0,0,0,0,0,0,0,0,1,5,2,2,0,20,7,337
20,20,20,20,20,2,18,20,18,18,18,2,2,1,1,0,0,0,0,0,0,0,0,0,0,0,1,0,2,17,0,20,6,338
20,20,20,20,20,2,18,19,18,18,18,1,1,1,1,0,0,0,0,0,0,0,0,0,0,0,1,0,1,17,0,20,6,339
20,20,20,20,20,6,14,14,14,14,14,1,1,1,1,0,0,0,0,0,0,0,0,0,0,0,1,0,0,13,0,20,6,340
20,20,20,20,20,2,18,20,18,18,18,2,2,1,1,0,0,0,0,0,0,0,0,0,0,0,1,0,2,17,0,20,6,341
20,20,20,20,20,2,18,19,18,18,18,1,1,1,1,0,0,0,0,0,0,0,0,0,0,0,1,0,1,17,0,20,6,342
20,20,20,20,20,6,14,16,14,14,14,2,2,1,1,0,0,0,0,0,0,0,0,0,0,0,1,0,2,13,0,20,6,343
20,20,20,20,20,8,12,12,12,12,12,1,1,1,1,0,0,0,0,0,0,0,0,0,0,0,1,0,0,11,0,20,6,344
20,20,21,20,20,20,1,1,1,1,1,1,1,1,0,0,0,0,0,0,0,0,0,0,0,0,0,1,0,0,0,20,6,345
20,20,20,20,20,2,18,19,18,18,18,1,1,1,1,0,0,0,0,0,0,0,0,0,0,0,1,0,1,17,0,20,7,346
20,20,35,20,20,20,15,15,15,15,15,15,15,15,0,0,0,0,0,0,0,0,0,0,0,0,0,15,0,0,0,20,6,347
20,20,20,20,20,2,18,20,18,18,18,2,2,1,1,0,0,0,0,0,0,0,0,0,0,0,1,0,2,17,0,20,6,348
20,20,20,20,20,8,12,12,12,12,12,1,1,1,1,0,0,0,0,0,0,0,0,0,0,0,1,0,0,11,0,20,6,349
20,20,29,20,20,18,11,12,11,11,11,10,10,10,1,0,0,0,0,0,0,0,0,0,0,0,1,9,1,1,0,20,6,350
20,20,24,20,20,20,4,4,4,4,4,4,4,4,0,0,0,0,0,0,0,0,0,0,0,0,0,4,0,0,0,20,6,351
20,20,20,20,20,2,18,18,18,18,18,2,2,1,1,0,0,0,0,0,0,0,0,0,0,0,1,0,1,16,0,20,6,352
20,20,20,20,20,20,0,0,0,0,0,0,0,0,0,0,0,0,0,0,0,0,0,0,0,0,0,0,0,0,0,20,6,353
20,20,20,20,20,2,18,20,18,18,18,2,2,1,1,0,0,0,0,0,0,0,0,0,0,0,1,0,2,17,0,20,6,354
20,20,20,20,20,20,0,0,0,0,0,0,0,0,0,0,0,0,0,0,0,0,0,0,0,0,0,0,0,0,0,20,6,355
20,20,20,20,20,8,12,12,12,12,12,1,1,1,1,0,0,0,0,0,0,0,0,0,0,0,1,0,0,11,0,20,4,356
20,20,20,20,20,6,14,14,14,14,14,1,1,1,1,0,0,0,0,0,0,0,0,0,0,0,1,0,0,13,0,20,6,357
20,20,20,20,20,4,16,16,16,16,16,2,2,1,1,0,0,0,0,0,0,0,0,0,0,0,1,0,1,14,0,20,6,358
20,20,20,20,20,20,0,0,0,0,0,0,0,0,0,0,0,0,0,0,0,0,0,0,0,0,0,0,0,0,0,20,6,359
20,20,20,20,20,6,14,14,14,14,14,1,1,1,1,0,0,0,0,0,0,0,0,0,0,0,1,0,0,13,0,20,6,360
20,20,20,20,20,2,18,18,18,18,18,1,1,1,1,0,0,0,0,0,0,0,0,0,0,0,1,0,0,17,0,20,6,361
20,20,20,20,20,20,0,0,0,0,0,0,0,0,0,0,0,0,0,0,0,0,0,0,0,0,0,0,0,0,0,20,5,362
20,20,20,20,20,20,0,0,0,0,0,0,0,0,0,0,0,0,0,0,0,0,0,0,0,0,0,0,0,0,0,20,4,363
20,20,20,20,20,6,14,14,14,14,14,1,1,1,1,0,0,0,0,0,0,0,0,0,0,0,1,0,0,13,0,20,7,364
20,20,21,20,20,12,9,9,9,9,9,2,2,2,1,0,0,0,0,0,0,0,0,0,0,0,1,1,0,7,0,20,6,365
20,20,20,20,20,20,0,0,0,0,0,0,0,0,0,0,0,0,0,0,0,0,0,0,0,0,0,0,0,0,0,20,5,366
20,20,20,20,20,2,18,18,18,18,18,2,2,1,1,0,0,0,0,0,0,0,0,0,0,0,1,0,1,16,0,20,6,367
20,20,20,20,20,6,14,14,14,14,14,1,1,1,1,0,0,0,0,0,0,0,0,0,0,0,1,0,0,13,0,20,5,368
20,20,24,20,20,20,4,4,4,4,4,4,4,4,0,0,0,0,0,0,0,0,0,0,0,0,0,4,0,0,0,20,5,369
20,20,20,20,20,2,18,18,18,18,18,2,2,1,1,0,0,0,0,0,0,0,0,0,0,0,1,0,1,16,0,20,5,370
20,20,20,20,20,20,0,0,0,0,0,0,0,0,0,0,0,0,0,0,0,0,0,0,0,0,0,0,0,0,0,20,5,371
20,20,20,20,20,20,0,0,0,0,0,0,0,0,0,0,0,0,0,0,0,0,0,0,0,0,0,0,0,0,0,20,5,372
20,20,20,20,20,20,0,0,0,0,0,0,0,0,0,0,0,0,0,0,0,0,0,0,0,0,0,0,0,0,0,20,5,373
20,20,20,20,20,4,16,16,16,16,16,2,2,1,1,0,0,0,0,0,0,0,0,0,0,0,1,0,1,14,0,20,5,374
20,20,23,20,20,20,3,3,3,3,3,3,3,3,0,0,0,0,0,0,0,0,0,0,0,0,0,3,0,0,0,20,5,375
20,20,21,20,20,6,15,15,15,15,15,2,2,2,1,0,0,0,0,0,0,0,0,0,0,0,1,1,0,13,0,20,6,376
20,20,21,20,20,20,1,1,1,1,1,1,1,1,0,0,0,0,0,0,0,0,0,0,0,0,0,1,0,0,0,20,5,377
20,20,21,20,20,4,17,17,17,17,17,3,3,2,1,0,0,0,0,0,0,0,0,0,0,0,1,1,1,14,0,20,5,378
20,20,20,20,20,20,0,0,0,0,0,0,0,0,0,0,0,0,0,0,0,0,0,0,0,0,0,0,0,0,0,20,5,379
20,20,20,20,20,20,0,0,0,0,0,0,0,0,0,0,0,0,0,0,0,0,0,0,0,0,0,0,0,0,0,20,5,380
20,20,20,20,20,2,18,19,18,18,18,1,1,1,1,0,0,0,0,0,0,0,0,0,0,0,1,0,1,17,0,20,5,381
20,20,21,20,20,20,1,1,1,1,1,1,1,1,0,0,0,0,0,0,0,0,0,0,0,0,0,1,0,0,0,20,5,382
20,20,20,20,20,6,14,14,14,14,14,1,1,1,1,0,0,0,0,0,0,0,0,0,0,0,1,0,0,13,0,20,5,383
20,20,21,20,20,3,18,19,18,18,18,3,2,1,0,0,0,0,0,0,0,0,0,0,0,0,0,1,2,16,0,20,5,384
20,20,21,20,20,20,1,1,1,1,1,1,1,1,0,0,0,0,0,0,0,0,0,0,0,0,0,1,0,0,0,20,5,385
20,20,20,20,20,2,18,18,18,18,18,2,2,1,1,0,0,0,0,0,0,0,0,0,0,0,1,0,1,16,0,20,5,386
20,20,20,20,20,3,17,17,17,17,17,2,2,1,1,0,0,0,0,0,0,0,0,0,0,0,1,0,1,15,0,20,5,387
20,20,20,20,20,6,14,14,14,14,14,1,1,1,1,0,0,0,0,0,0,0,0,0,0,0,1,0,0,13,0,20,5,388
20,20,22,20,20,20,2,2,2,2,2,2,2,2,0,0,0,0,0,0,0,0,0,0,0,0,0,2,0,0,0,20,5,389
20,20,21,20,20,6,15,15,15,15,15,2,2,2,1,0,0,0,0,0,0,0,0,0,0,0,1,1,0,13,0,20,5,390
20,20,21,20,20,20,1,1,1,1,1,1,1,1,0,0,0,0,0,0,0,0,0,0,0,0,0,1,0,0,0,20,5,391
20,20,20,20,20,3,17,17,17,17,17,2,2,1,1,0,0,0,0,0,0,0,0,0,0,0,1,0,1,15,0,20,5,392
20,20,20,20,20,2,18,19,18,18,18,2,2,1,1,0,0,0,0,0,0,0,0,0,0,0,1,0,2,16,0,20,5,393
20,20,20,20,20,2,18,20,18,18,18,2,2,1,1,0,0,0,0,0,0,0,0,0,0,0,1,0,2,17,0,20,6,394
20,20,20,20,20,18,2,2,2,2,2,1,1,1,1,0,0,0,0,0,0,0,0,0,0,0,1,0,0,1,0,20,5,395
20,20,24,20,20,20,4,4,4,4,4,4,4,4,0,0,0,0,0,0,0,0,0,0,0,0,0,4,0,0,0,20,6,396
20,20,20,20,20,3,17,17,17,17,17,2,2,1,1,0,0,0,0,0,0,0,0,0,0,0,1,0,1,15,0,20,5,397
20,20,34,20,20,20,14,14,14,14,14,14,14,14,0,0,0,0,0,0,0,0,0,0,0,0,0,14,0,0,0,20,6,398
20,20,20,20,20,20,0,0,0,0,0,0,0,0,0,0,0,0,0,0,0,0,0,0,0,0,0,0,0,0,0,20,5,399
20,20,20,20,20,2,18,20,18,18,18,2,2,1,1,0,0,0,0,0,0,0,0,0,0,0,1,0,2,17,0,20,5,400
20,20,21,20,20,20,1,1,1,1,1,1,1,1,0,0,0,0,0,0,0,0,0,0,0,0,0,1,0,0,0,20,5,401
20,20,20,20,20,2,18,18,18,18,18,2,2,1,1,0,0,0,0,0,0,0,0,0,0,0,1,0,1,16,0,20,5,402
20,20,21,20,20,20,1,1,1,1,1,1,1,1,0,0,0,0,0,0,0,0,0,0,0,0,0,1,0,0,0,20,5,403
20,20,20,20,20,20,0,0,0,0,0,0,0,0,0,0,0,0,0,0,0,0,0,0,0,0,0,0,0,0,0,20,5,404
20,20,20,20,20,20,0,0,0,0,0,0,0,0,0,0,0,0,0,0,0,0,0,0,0,0,0,0,0,0,0,20,5,405
20,20,21,20,20,6,15,15,15,15,15,3,3,2,1,0,0,0,0,0,0,0,0,0,0,0,1,1,1,12,0,20,5,406
20,20,20,20,20,20,0,0,0,0,0,0,0,0,0,0,0,0,0,0,0,0,0,0,0,0,0,0,0,0,0,20,5,407
20,20,21,20,20,10,11,12,11,11,11,3,3,2,1,0,0,0,0,0,0,0,0,0,0,0,1,1,2,8,0,20,5,408
20,20,20,20,20,20,0,0,0,0,0,0,0,0,0,0,0,0,0,0,0,0,0,0,0,0,0,0,0,0,0,20,5,409
20,20,20,20,20,2,18,20,18,18,18,2,2,1,1,0,0,0,0,0,0,0,0,0,0,0,1,0,2,17,0,20,5,410
20,20,20,20,20,2,18,18,18,18,18,2,2,1,1,0,0,0,0,0,0,0,0,0,0,0,1,0,1,16,0,20,5,411
20,20,20,20,20,2,18,20,18,18,18,2,2,1,1,0,0,0,0,0,0,0,0,0,0,0,1,0,2,17,0,20,5,412
20,20,20,20,20,20,0,0,0,0,0,0,0,0,0,0,0,0,0,0,0,0,0,0,0,0,0,0,0,0,0,20,5,413
20,20,20,20,20,20,0,0,0,0,0,0,0,0,0,0,0,0,0,0,0,0,0,0,0,0,0,0,0,0,0,20,5,414
20,20,20,20,20,20,0,0,0,0,0,0,0,0,0,0,0,0,0,0,0,0,0,0,0,0,0,0,0,0,0,20,5,415
20,20,23,20,20,20,3,3,3,3,3,3,3,3,0,0,0,0,0,0,0,0,0,0,0,0,0,3,0,0,0,20,5,416
20,20,20,20,20,2,18,18,18,18,18,2,2,1,1,0,0,0,0,0,0,0,0,0,0,0,1,0,1,16,0,20,6,417
20,20,20,20,20,6,14,14,14,14,14,1,1,1,1,0,0,0,0,0,0,0,0,0,0,0,1,0,0,13,0,20,5,418
20,20,21,20,20,20,1,1,1,1,1,1,1,1,0,0,0,0,0,0,0,0,0,0,0,0,0,1,0,0,0,20,5,419
20,20,20,20,20,8,12,12,12,12,12,1,1,1,1,0,0,0,0,0,0,0,0,0,0,0,1,0,0,11,0,20,5,420
20,20,20,20,20,4,16,16,16,16,16,1,1,1,1,0,0,0,0,0,0,0,0,0,0,0,1,0,0,15,0,20,5,421
20,20,21,20,20,20,1,1,1,1,1,1,1,1,0,0,0,0,0,0,0,0,0,0,0,0,0,1,0,0,0,20,5,422
20,20,31,20,20,20,11,11,11,11,11,11,11,11,0,0,0,0,0,0,0,0,0,0,0,0,0,11,0,0,0,20,5,423
20,20,20,20,20,2,18,19,18,18,18,1,1,1,1,0,0,0,0,0,0,0,0,0,0,0,1,0,1,17,0,20,5,424
20,20,20,20,20,3,17,17,17,17,17,2,2,1,1,0,0,0,0,0,0,0,0,0,0,0,1,0,1,15,0,20,5,425
20,20,20,20,20,20,0,0,0,0,0,0,0,0,0,0,0,0,0,0,0,0,0,0,0,0,0,0,0,0,0,20,5,426
20,20,21,20,20,20,1,1,1,1,1,1,1,1,0,0,0,0,0,0,0,0,0,0,0,0,0,1,0,0,0,20,6,427
20,20,20,20,20,2,18,18,18,18,18,2,2,1,1,0,0,0,0,0,0,0,0,0,0,0,1,0,1,16,0,20,5,428
20,20,20,20,20,3,17,17,17,17,17,2,2,1,1,0,0,0,0,0,0,0,0,0,0,0,1,0,1,15,0,20,5,429
20,20,20,20,20,2,18,19,18,18,18,1,1,1,1,0,0,0,0,0,0,0,0,0,0,0,1,0,1,17,0,20,5,430
20,20,22,20,20,6,16,17,16,16,16,3,3,3,1,0,0,0,0,0,0,0,0,0,0,0,1,2,1,13,0,20,5,431
20,20,20,20,20,2,18,20,18,18,18,2,2,1,1,0,0,0,0,0,0,0,0,0,0,0,1,0,2,17,0,20,5,432
20,20,22,20,20,20,2,2,2,2,2,2,2,2,0,0,0,0,0,0,0,0,0,0,0,0,0,2,0,0,0,20,5,433
20,20,20,20,20,2,18,18,18,18,18,2,2,1,1,0,0,0,0,0,0,0,0,0,0,0,1,0,1,16,0,20,6,434
20,20,20,20,20,2,18,19,18,18,18,1,1,1,1,0,0,0,0,0,0,0,0,0,0,0,1,0,1,17,0,20,5,435
20,20,20,20,20,6,14,14,14,14,14,2,2,1,1,0,0,0,0,0,0,0,0,0,0,0,1,0,1,12,0,20,6,436
20,20,20,20,20,20,0,0,0,0,0,0,0,0,0,0,0,0,0,0,0,0,0,0,0,0,0,0,0,0,0,20,5,437
20,20,20,20,20,3,17,17,17,17,17,2,2,1,1,0,0,0,0,0,0,0,0,0,0,0,1,0,1,15,0,20,6,438
20,20,20,20,20,14,6,7,6,6,6,1,1,1,1,0,0,0,0,0,0,0,0,0,0,0,1,0,1,5,0,20,6,439
20,20,20,20,20,20,0,0,0,0,0,0,0,0,0,0,0,0,0,0,0,0,0,0,0,0,0,0,0,0,0,20,6,440
20,20,21,20,20,20,1,1,1,1,1,1,1,1,0,0,0,0,0,0,0,0,0,0,0,0,0,1,0,0,0,20,6,441
20,20,21,20,20,8,13,13,13,13,13,2,2,2,1,0,0,0,0,0,0,0,0,0,0,0,1,1,0,11,0,20,6,442
20,20,20,20,20,2,18,18,18,18,18,2,2,1,1,0,0,0,0,0,0,0,0,0,0,0,1,0,1,16,0,20,6,443
20,20,20,20,20,2,18,18,18,18,18,2,2,1,1,0,0,0,0,0,0,0,0,0,0,0,1,0,1,16,0,20,6,444
20,20,20,20,20,2,18,18,18,18,18,2,2,1,1,0,0,0,0,0,0,0,0,0,0,0,1,0,1,16,0,20,6,445
20,20,23,20,20,20,3,3,3,3,3,3,3,3,0,0,0,0,0,0,0,0,0,0,0,0,0,3,0,0,0,20,6,446
20,20,20,20,20,2,18,19,18,18,18,2,2,1,1,0,0,0,0,0,0,0,0,0,0,0,1,0,1,17,0,20,5,447
20,20,23,20,20,20,3,3,3,3,3,3,3,3,0,0,0,0,0,0,0,0,0,0,0,0,0,3,0,0,0,20,6,448
20,20,20,20,20,6,14,14,14,14,14,2,2,1,1,0,0,0,0,0,0,0,0,0,0,0,1,0,1,12,0,20,6,449
20,20,20,20,20,2,18,18,18,18,18,1,1,1,1,0,0,0,0,0,0,0,0,0,0,0,1,0,0,17,0,20,6,450
20,20,21,20,20,20,1,1,1,1,1,1,1,1,0,0,0,0,0,0,0,0,0,0,0,0,0,1,0,0,0,20,6,451
20,20,20,20,20,2,18,18,18,18,18,1,1,1,1,0,0,0,0,0,0,0,0,0,0,0,1,0,0,17,0,20,6,452
20,20,20,20,20,2,18,19,18,18,18,1,1,1,1,0,0,0,0,0,0,0,0,0,0,0,1,0,1,17,0,20,6,453
20,20,20,20,20,20,0,0,0,0,0,0,0,0,0,0,0,0,0,0,0,0,0,0,0,0,0,0,0,0,0,20,6,454
20,20,20,20,20,6,14,14,14,14,14,1,1,1,1,0,0,0,0,0,0,0,0,0,0,0,1,0,0,13,0,20,6,455
20,20,20,20,20,2,18,19,18,18,18,1,1,1,1,0,0,0,0,0,0,0,0,0,0,0,1,0,1,17,0,20,6,456
20,20,20,20,20,2,18,18,18,18,18,2,2,1,1,0,0,0,0,0,0,0,0,0,0,0,1,0,1,16,0,20,6,457
20,20,20,20,20,2,18,19,18,18,18,2,2,1,1,0,0,0,0,0,0,0,0,0,0,0,1,0,2,16,0,20,6,458
20,20,20,20,20,12,8,8,8,8,8,1,1,1,1,0,0,0,0,0,0,0,0,0,0,0,1,0,0,7,0,20,6,459
20,20,20,20,20,6,14,14,14,14,14,1,1,1,1,0,0,0,0,0,0,0,0,0,0,0,1,0,0,13,0,20,6,460
20,20,20,20,20,2,18,19,18,18,18,1,1,1,1,0,0,0,0,0,0,0,0,0,0,0,1,0,1,17,0,20,7,461
20,20,20,20,20,2,18,19,18,18,18,2,2,1,1,0,0,0,0,0,0,0,0,0,0,0,1,0,1,17,0,20,5,462
20,20,21,20,20,6,15,15,15,15,15,2,2,2,1,0,0,0,0,0,0,0,0,0,0,0,1,1,0,13,0,20,4,463
20,20,20,20,20,20,0,0,0,0,0,0,0,0,0,0,0,0,0,0,0,0,0,0,0,0,0,0,0,0,0,20,6,464
20,20,24,20,20,20,4,4,4,4,4,4,4,4,0,0,0,0,0,0,0,0,0,0,0,0,0,4,0,0,0,20,6,465
20,20,20,20,20,2,18,19,18,18,18,1,1,1,1,0,0,0,0,0,0,0,0,0,0,0,1,0,1,17,0,20,6,466
20,20,20,20,20,2,18,19,18,18,18,1,1,1,1,0,0,0,0,0,0,0,0,0,0,0,1,0,1,17,0,20,6,467
20,20,20,20,20,6,14,14,14,14,14,1,1,1,1,0,0,0,0,0,0,0,0,0,0,0,1,0,0,13,0,20,6,468
20,20,28,20,20,20,8,8,8,8,8,8,8,8,0,0,0,0,0,0,0,0,0,0,0,0,0,8,0,0,0,20,7,469
20,20,20,20,20,2,18,18,18,18,18,2,2,1,1,0,0,0,0,0,0,0,0,0,0,0,1,0,1,16,0,20,7,470
20,20,20,20,20,3,17,17,17,17,17,2,2,1,1,0,0,0,0,0,0,0,0,0,0,0,1,0,1,15,0,20,6,471
20,20,22,20,20,20,2,2,2,2,2,2,2,2,0,0,0,0,0,0,0,0,0,0,0,0,0,2,0,0,0,20,7,472
20,20,24,20,20,20,4,4,4,4,4,4,4,4,0,0,0,0,0,0,0,0,0,0,0,0,0,4,0,0,0,20,5,473
20,20,20,20,20,20,0,0,0,0,0,0,0,0,0,0,0,0,0,0,0,0,0,0,0,0,0,0,0,0,0,20,6,474
20,20,20,20,20,20,0,0,0,0,0,0,0,0,0,0,0,0,0,0,0,0,0,0,0,0,0,0,0,0,0,20,7,475
20,20,21,20,20,6,15,15,15,15,15,2,2,2,1,0,0,0,0,0,0,0,0,0,0,0,1,1,0,13,0,20,7,476
20,20,20,20,20,2,18,18,18,18,18,2,2,1,1,0,0,0,0,0,0,0,0,0,0,0,1,0,1,16,0,20,6,477
20,20,22,20,20,20,2,2,2,2,2,2,2,2,0,0,0,0,0,0,0,0,0,0,0,0,0,2,0,0,0,20,6,478
20,20,20,20,20,6,14,14,14,14,14,1,1,1,1,0,0,0,0,0,0,0,0,0,0,0,1,0,0,13,0,20,6,479
20,20,29,20,20,20,9,9,9,9,9,9,9,9,0,0,0,0,0,0,0,0,0,0,0,0,0,9,0,0,0,20,7,480
20,20,20,20,20,2,18,19,18,18,18,2,2,1,1,0,0,0,0,0,0,0,0,0,0,0,1,0,1,17,0,20,5,481
20,20,20,20,20,5,15,15,15,15,15,2,2,2,1,0,0,0,0,0,0,0,0,0,0,0,1,1,0,13,0,20,5,482
20,20,20,20,20,2,18,19,18,18,18,1,1,1,1,0,0,0,0,0,0,0,0,0,0,0,1,0,1,17,0,20,5,483
20,20,22,20,20,6,16,16,16,16,16,3,3,3,1,0,0,0,0,0,0,0,0,0,0,0,1,2,0,13,0,20,4,484
20,20,20,20,20,20,0,0,0,0,0,0,0,0,0,0,0,0,0,0,0,0,0,0,0,0,0,0,0,0,0,20,6,485
20,20,21,20,20,20,1,1,1,1,1,1,1,1,0,0,0,0,0,0,0,0,0,0,0,0,0,1,0,0,0,20,7,486
20,20,21,20,20,6,15,15,15,15,15,2,2,2,1,0,0,0,0,0,0,0,0,0,0,0,1,1,0,13,0,20,5,487
20,20,21,20,20,20,1,1,1,1,1,1,1,1,0,0,0,0,0,0,0,0,0,0,0,0,0,1,0,0,0,20,6,488
20,20,20,20,20,2,18,18,18,18,18,1,1,1,1,0,0,0,0,0,0,0,0,0,0,0,1,0,0,17,0,20,4,489
20,20,20,20,20,20,0,0,0,0,0,0,0,0,0,0,0,0,0,0,0,0,0,0,0,0,0,0,0,0,0,20,5,490
20,20,20,20,20,10,10,10,10,10,10,1,1,1,1,0,0,0,0,0,0,0,0,0,0,0,1,0,0,9,0,20,5,491
20,20,20,20,20,2,18,19,18,18,18,2,2,1,1,0,0,0,0,0,0,0,0,0,0,0,1,0,1,17,0,20,5,492
20,20,21,20,20,20,1,1,1,1,1,1,1,1,0,0,0,0,0,0,0,0,0,0,0,0,0,1,0,0,0,20,5,493
20,20,20,20,20,2,18,18,18,18,18,2,2,1,1,0,0,0,0,0,0,0,0,0,0,0,1,0,1,16,0,20,7,494
20,20,21,20,20,20,1,1,1,1,1,1,1,1,0,0,0,0,0,0,0,0,0,0,0,0,0,1,0,0,0,20,5,495
20,20,20,20,20,2,18,19,18,18,18,1,1,1,1,0,0,0,0,0,0,0,0,0,0,0,1,0,1,17,0,20,6,496
20,20,20,20,20,20,0,0,0,0,0,0,0,0,0,0,0,0,0,0,0,0,0,0,0,0,0,0,0,0,0,20,6,497
20,20,20,20,20,2,18,18,18,18,18,2,2,1,1,0,0,0,0,0,0,0,0,0,0,0,1,0,1,16,0,20,5,498
20,20,20,20,20,5,15,16,15,15,15,1,1,1,1,0,0,0,0,0,0,0,0,0,0,0,1,0,1,14,0,20,6,499
20,20,20,20,20,20,0,0,0,0,0,0,0,0,0,0,0,0,0,0,0,0,0,0,0,0,0,0,0,0,0,20,5,500
20,20,22,20,20,20,2,2,2,2,2,2,2,2,0,0,0,0,0,0,0,0,0,0,0,0,0,2,0,0,0,20,5,501
20,20,20,20,20,2,18,18,18,18,18,1,1,1,1,0,0,0,0,0,0,0,0,0,0,0,1,0,0,17,0,20,5,502
20,20,20,20,20,20,0,0,0,0,0,0,0,0,0,0,0,0,0,0,0,0,0,0,0,0,0,0,0,0,0,20,6,503
20,20,24,20,20,20,4,4,4,4,4,4,4,4,0,0,0,0,0,0,0,0,0,0,0,0,0,4,0,0,0,20,6,504
20,20,20,20,20,2,18,18,18,18,18,2,2,1,1,0,0,0,0,0,0,0,0,0,0,0,1,0,1,16,0,20,6,505
20,20,20,20,20,14,6,6,6,6,6,1,1,1,1,0,0,0,0,0,0,0,0,0,0,0,1,0,0,5,0,20,6,506
20,20,20,20,20,2,18,19,18,18,18,1,1,1,1,0,0,0,0,0,0,0,0,0,0,0,1,0,1,17,0,20,6,507
20,20,20,20,20,2,18,19,18,18,18,1,1,1,1,0,0,0,0,0,0,0,0,0,0,0,1,0,1,17,0,20,4,508
20,20,20,20,20,2,18,18,18,18,18,2,2,1,1,0,0,0,0,0,0,0,0,0,0,0,1,0,1,16,0,20,6,509
20,20,21,20,20,8,13,13,13,13,13,2,2,2,1,0,0,0,0,0,0,0,0,0,0,0,1,1,0,11,0,20,5,510
20,20,20,20,20,2,18,19,18,18,18,1,1,1,1,0,0,0,0,0,0,0,0,0,0,0,1,0,1,17,0,20,5,511
160
162
160
162
1,1,1,1,1,1,0,0,0,0,0,0,0,0,0,0,0,0,0,0,0,0,0,0,0,0,0,0,0,0,0,1,1,160
1,1,1,1,1,1,0,0,0,0,0,0,0,0,0,0,0,0,0,0,0,0,0,0,0,0,0,0,0,0,0,1,1,162
1,0,0,0,0,0,0,0,0,0,0,0,0,0,0,0,0,0,0,0,0,0,0,0,0,0,0,0,0,0,0,1,1,128
1,1,1,1,1,1,0,0,0,0,0,0,0,0,0,0,0,0,0,0,0,0,0,0,0,0,0,0,0,0,0,1,1,130
1,1,1,1,1,1,0,0,0,0,0,0,0,0,0,0,0,0,0,0,0,0,0,0,0,0,0,0,0,0,0,1,1,132
1,1,1,1,1,1,0,0,0,0,0,0,0,0,0,0,0,0,0,0,0,0,0,0,0,0,0,0,0,0,0,1,1,134
1,1,1,1,1,1,0,0,0,0,0,0,0,0,0,0,0,0,0,0,0,0,0,0,0,0,0,0,0,0,0,1,1,136
1,1,1,1,1,1,0,0,0,0,0,0,0,0,0,0,0,0,0,0,0,0,0,0,0,0,0,0,0,0,0,1,1,138
1,1,1,1,1,1,0,0,0,0,0,0,0,0,0,0,0,0,0,0,0,0,0,0,0,0,0,0,0,0,0,1,1,140
1,1,1,1,1,1,0,0,0,0,0,0,0,0,0,0,0,0,0,0,0,0,0,0,0,0,0,0,0,0,0,1,1,142
1,1,1,1,1,1,0,0,0,0,0,0,0,0,0,0,0,0,0,0,0,0,0,0,0,0,0,0,0,0,0,1,1,144
1,1,1,1,1,1,0,0,0,0,0,0,0,0,0,0,0,0,0,0,0,0,0,0,0,0,0,0,0,0,0,1,1,146
1,1,1,1,1,1,0,0,0,0,0,0,0,0,0,0,0,0,0,0,0,0,0,0,0,0,0,0,0,0,0,1,1,148
1,1,1,1,1,1,0,0,0,0,0,0,0,0,0,0,0,0,0,0,0,0,0,0,0,0,0,0,0,0,0,1,1,150
1,1,1,1,1,1,0,0,0,0,0,0,0,0,0,0,0,0,0,0,0,0,0,0,0,0,0,0,0,0,0,1,1,152
1,1,1,1,1,1,0,0,0,0,0,0,0,0,0,0,0,0,0,0,0,0,0,0,0,0,0,0,0,0,0,1,1,154
1,1,1,1,1,1,0,0,0,0,0,0,0,0,0,0,0,0,0,0,0,0,0,0,0,0,0,0,0,0,0,1,1,156
1,1,1,1,1,1,0,0,0,0,0,0,0,0,0,0,0,0,0,0,0,0,0,0,0,0,0,0,0,0,0,1,1,158
1,1,1,1,1,1,0,0,0,0,0,0,0,0,0,0,0,0,0,0,0,0,0,0,0,0,0,0,0,0,0,1,1,160
1,1,1,1,1,1,0,0,0,0,0,0,0,0,0,0,0,0,0,0,0,0,0,0,0,0,0,0,0,0,0,1,1,162
1,1,1,1,1,1,0,0,0,0,0,0,0,0,0,0,0,0,0,0,0,0,0,0,0,0,0,0,0,0,0,1,1,164
1,1,1,1,1,1,0,0,0,0,0,0,0,0,0,0,0,0,0,0,0,0,0,0,0,0,0,0,0,0,0,1,1,166
1,1,1,1,1,1,0,0,0,0,0,0,0,0,0,0,0,0,0,0,0,0,0,0,0,0,0,0,0,0,0,1,1,168
1,1,1,1,1,1,0,0,0,0,0,0,0,0,0,0,0,0,0,0,0,0,0,0,0,0,0,0,0,0,0,1,1,170
1,1,1,1,1,1,0,0,0,0,0,0,0,0,0,0,0,0,0,0,0,0,0,0,0,0,0,0,0,0,0,1,1,172
1,1,1,1,1,1,0,0,0,0,0,0,0,0,0,0,0,0,0,0,0,0,0,0,0,0,0,0,0,0,0,1,1,174
1,1,1,1,1,1,0,0,0,0,0,0,0,0,0,0,0,0,0,0,0,0,0,0,0,0,0,0,0,0,0,1,1,176
1,1,1,1,1,1,0,0,0,0,0,0,0,0,0,0,0,0,0,0,0,0,0,0,0,0,0,0,0,0,0,1,1,178
1,1,1,1,1,1,0,0,0,0,0,0,0,0,0,0,0,0,0,0,0,0,0,0,0,0,0,0,0,0,0,1,1,180
1,1,1,1,1,1,0,0,0,0,0,0,0,0,0,0,0,0,0,0,0,0,0,0,0,0,0,0,0,0,0,1,1,182
1,1,1,1,1,1,0,0,0,0,0,0,0,0,0,0,0,0,0,0,0,0,0,0,0,0,0,0,0,0,0,1,1,184
1,1,1,1,1,1,0,0,0,0,0,0,0,0,0,0,0,0,0,0,0,0,0,0,0,0,0,0,0,0,0,1,1,186
1,1,1,1,1,1,0,0,0,0,0,0,0,0,0,0,0,0,0,0,0,0,0,0,0,0,0,0,0,0,0,1,1,188
1,1,1,1,1,1,0,0,0,0,0,0,0,0,0,0,0,0,0,0,0,0,0,0,0,0,0,0,0,0,0,1,1,190
1,1,1,1,1,1,0,0,0,0,0,0,0,0,0,0,0,0,0,0,0,0,0,0,0,0,0,0,0,0,0,1,1,192
1,1,1,1,1,1,0,0,0,0,0,0,0,0,0,0,0,0,0,0,0,0,0,0,0,0,0,0,0,0,0,1,1,194
1,1,1,1,1,1,0,0,0,0,0,0,0,0,0,0,0,0,0,0,0,0,0,0,0,0,0,0,0,0,0,1,1,196
1,1,1,1,1,1,0,0,0,0,0,0,0,0,0,0,0,0,0,0,0,0,0,0,0,0,0,0,0,0,0,1,1,198
1,1,1,1,1,1,0,0,0,0,0,0,0,0,0,0,0,0,0,0,0,0,0,0,0,0,0,0,0,0,0,1,1,200
1,1,1,1,1,1,0,0,0,0,0,0,0,0,0,0,0,0,0,0,0,0,0,0,0,0,0,0,0,0,0,1,1,202
1,1,1,1,1,1,0,0,0,0,0,0,0,0,0,0,0,0,0,0,0,0,0,0,0,0,0,0,0,0,0,1,1,204
1,1,1,1,1,1,0,0,0,0,0,0,0,0,0,0,0,0,0,0,0,0,0,0,0,0,0,0,0,0,0,1,1,206
1,1,1,1,1,1,0,0,0,0,0,0,0,0,0,0,0,0,0,0,0,0,0,0,0,0,0,0,0,0,0,1,1,208
1,1,1,1,1,1,0,0,0,0,0,0,0,0,0,0,0,0,0,0,0,0,0,0,0,0,0,0,0,0,0,1,1,210
1,1,1,1,1,1,0,0,0,0,0,0,0,0,0,0,0,0,0,0,0,0,0,0,0,0,0,0,0,0,0,1,1,212
1,1,1,1,1,1,0,0,0,0,0,0,0,0,0,0,0,0,0,0,0,0,0,0,0,0,0,0,0,0,0,1,1,214
1,1,1,1,1,1,0,0,0,0,0,0,0,0,0,0,0,0,0,0,0,0,0,0,0,0,0,0,0,0,0,1,1,216
1,1,1,1,1,1,0,0,0,0,0,0,0,0,0,0,0,0,0,0,0,0,0,0,0,0,0,0,0,0,0,1,1,218
1,1,1,1,1,1,0,0,0,0,0,0,0,0,0,0,0,0,0,0,0,0,0,0,0,0,0,0,0,0,0,1,1,220
1,1,1,1,1,1,0,0,0,0,0,0,0,0,0,0,0,0,0,0,0,0,0,0,0,0,0,0,0,0,0,1,1,222
1,1,1,1,1,1,0,0,0,0,0,0,0,0,0,0,0,0,0,0,0,0,0,0,0,0,0,0,0,0,0,1,1,224
1,1,1,1,1,1,0,0,0,0,0,0,0,0,0,0,0,0,0,0,0,0,0,0,0,0,0,0,0,0,0,1,1,226
1,1,1,1,1,1,0,0,0,0,0,0,0,0,0,0,0,0,0,0,0,0,0,0,0,0,0,0,0,0,0,1,1,228
1,1,1,1,1,1,0,0,0,0,0,0,0,0,0,0,0,0,0,0,0,0,0,0,0,0,0,0,0,0,0,1,1,230
1,1,1,1,1,1,0,0,0,0,0,0,0,0,0,0,0,0,0,0,0,0,0,0,0,0,0,0,0,0,0,1,1,232
1,1,1,1,1,1,0,0,0,0,0,0,0,0,0,0,0,0,0,0,0,0,0,0,0,0,0,0,0,0,0,1,1,234
1,1,1,1,1,1,0,0,0,0,0,0,0,0,0,0,0,0,0,0,0,0,0,0,0,0,0,0,0,0,0,1,1,236
1,1,1,1,1,1,0,0,0,0,0,0,0,0,0,0,0,0,0,0,0,0,0,0,0,0,0,0,0,0,0,1,1,238
1,1,1,1,1,1,0,0,0,0,0,0,0,0,0,0,0,0,0,0,0,0,0,0,0,0,0,0,0,0,0,1,1,240
1,1,1,1,1,1,0,0,0,0,0,0,0,0,0,0,0,0,0,0,0,0,0,0,0,0,0,0,0,0,0,1,1,242
1,1,1,1,1,1,0,0,0,0,0,0,0,0,0,0,0,0,0,0,0,0,0,0,0,0,0,0,0,0,0,1,1,244
1,1,1,1,1,1,0,0,0,0,0,0,0,0,0,0,0,0,0,0,0,0,0,0,0,0,0,0,0,0,0,1,1,246
1,1,1,1,1,1,0,0,0,0,0,0,0,0,0,0,0,0,0,0,0,0,0,0,0,0,0,0,0,0,0,1,1,248
1,1,1,1,1,1,0,0,0,0,0,0,0,0,0,0,0,0,0,0,0,0,0,0,0,0,0,0,0,0,0,1,1,250
1,1,1,1,1,1,0,0,0,0,0,0,0,0,0,0,0,0,0,0,0,0,0,0,0,0,0,0,0,0,0,1,1,252
1,1,1,1,1,1,0,0,0,0,0,0,0,0,0,0,0,0,0,0,0,0,0,0,0,0,0,0,0,0,0,1,1,254
1,1,1,1,1,1,0,0,0,0,0,0,0,0,0,0,0,0,0,0,0,0,0,0,0,0,0,0,0,0,0,1,1,256
1,1,1,1,1,1,0,0,0,0,0,0,0,0,0,0,0,0,0,0,0,0,0,0,0,0,0,0,0,0,0,1,1,258
1,1,1,1,1,1,0,0,0,0,0,0,0,0,0,0,0,0,0,0,0,0,0,0,0,0,0,0,0,0,0,1,1,260
1,1,1,1,1,1,0,0,0,0,0,0,0,0,0,0,0,0,0,0,0,0,0,0,0,0,0,0,0,0,0,1,1,262
1,1,1,1,1,1,0,0,0,0,0,0,0,0,0,0,0,0,0,0,0,0,0,0,0,0,0,0,0,0,0,1,1,264
1,1,1,1,1,1,0,0,0,0,0,0,0,0,0,0,0,0,0,0,0,0,0,0,0,0,0,0,0,0,0,1,1,266
1,1,1,1,1,1,0,0,0,0,0,0,0,0,0,0,0,0,0,0,0,0,0,0,0,0,0,0,0,0,0,1,1,268
1,1,1,1,1,1,0,0,0,0,0,0,0,0,0,0,0,0,0,0,0,0,0,0,0,0,0,0,0,0,0,1,1,270
1,1,1,1,1,1,0,0,0,0,0,0,0,0,0,0,0,0,0,0,0,0,0,0,0,0,0,0,0,0,0,1,1,272
1,1,1,1,1,1,0,0,0,0,0,0,0,0,0,0,0,0,0,0,0,0,0,0,0,0,0,0,0,0,0,1,1,274
1,1,1,1,1,1,0,0,0,0,0,0,0,0,0,0,0,0,0,0,0,0,0,0,0,0,0,0,0,0,0,1,1,276
1,1,1,1,1,1,0,0,0,0,0,0,0,0,0,0,0,0,0,0,0,0,0,0,0,0,0,0,0,0,0,1,1,278
1,1,1,1,1,1,0,0,0,0,0,0,0,0,0,0,0,0,0,0,0,0,0,0,0,0,0,0,0,0,0,1,1,280
1,1,1,1,1,1,0,0,0,0,0,0,0,0,0,0,0,0,0,0,0,0,0,0,0,0,0,0,0,0,0,1,1,282
1,1,1,1,1,1,0,0,0,0,0,0,0,0,0,0,0,0,0,0,0,0,0,0,0,0,0,0,0,0,0,1,1,284
1,1,1,1,1,1,0,0,0,0,0,0,0,0,0,0,0,0,0,0,0,0,0,0,0,0,0,0,0,0,0,1,1,286
1,1,1,1,1,1,0,0,0,0,0,0,0,0,0,0,0,0,0,0,0,0,0,0,0,0,0,0,0,0,0,1,1,288
1,1,1,1,1,1,0,0,0,0,0,0,0,0,0,0,0,0,0,0,0,0,0,0,0,0,0,0,0,0,0,1,1,290
1,1,1,1,1,1,0,0,0,0,0,0,0,0,0,0,0,0,0,0,0,0,0,0,0,0,0,0,0,0,0,1,1,292
1,1,1,1,1,1,0,0,0,0,0,0,0,0,0,0,0,0,0,0,0,0,0,0,0,0,0,0,0,0,0,1,1,294
1,1,1,1,1,1,0,0,0,0,0,0,0,0,0,0,0,0,0,0,0,0,0,0,0,0,0,0,0,0,0,1,1,296
1,1,1,1,1,1,0,0,0,0,0,0,0,0,0,0,0,0,0,0,0,0,0,0,0,0,0,0,0,0,0,1,1,298
1,1,1,1,1,1,0,0,0,0,0,0,0,0,0,0,0,0,0,0,0,0,0,0,0,0,0,0,0,0,0,1,1,300
1,1,1,1,1,1,0,0,0,0,0,0,0,0,0,0,0,0,0,0,0,0,0,0,0,0,0,0,0,0,0,1,1,302
1,1,1,1,1,1,0,0,0,0,0,0,0,0,0,0,0,0,0,0,0,0,0,0,0,0,0,0,0,0,0,1,1,304
1,1,1,1,1,1,0,0,0,0,0,0,0,0,0,0,0,0,0,0,0,0,0,0,0,0,0,0,0,0,0,1,1,306
1,1,1,1,1,1,0,0,0,0,0,0,0,0,0,0,0,0,0,0,0,0,0,0,0,0,0,0,0,0,0,1,1,308
1,1,1,1,1,1,0,0,0,0,0,0,0,0,0,0,0,0,0,0,0,0,0,0,0,0,0,0,0,0,0,1,1,310
1,1,1,1,1,1,0,0,0,0,0,0,0,0,0,0,0,0,0,0,0,0,0,0,0,0,0,0,0,0,0,1,1,312
1,1,1,1,1,1,0,0,0,0,0,0,0,0,0,0,0,0,0,0,0,0,0,0,0,0,0,0,0,0,0,1,1,314
1,1,1,1,1,1,0,0,0,0,0,0,0,0,0,0,0,0,0,0,0,0,0,0,0,0,0,0,0,0,0,1,1,316
1,1,1,1,1,1,0,0,0,0,0,0,0,0,0,0,0,0,0,0,0,0,0,0,0,0,0,0,0,0,0,1,1,318
1,1,1,1,1,1,0,0,0,0,0,0,0,0,0,0,0,0,0,0,0,0,0,0,0,0,0,0,0,0,0,1,1,320
1,1,1,1,1,1,0,0,0,0,0,0,0,0,0,0,0,0,0,0,0,0,0,0,0,0,0,0,0,0,0,1,1,322
1,1,1,1,1,1,0,0,0,0,0,0,0,0,0,0,0,0,0,0,0,0,0,0,0,0,0,0,0,0,0,1,1,324
1,1,1,1,1,1,0,0,0,0,0,0,0,0,0,0,0,0,0,0,0,0,0,0,0,0,0,0,0,0,0,1,1,326
1,1,1,1,1,1,0,0,0,0,0,0,0,0,0,0,0,0,0,0,0,0,0,0,0,0,0,0,0,0,0,1,1,328
1,1,1,1,1,1,0,0,0,0,0,0,0,0,0,0,0,0,0,0,0,0,0,0,0,0,0,0,0,0,0,1,1,330
1,1,1,1,1,1,0,0,0,0,0,0,0,0,0,0,0,0,0,0,0,0,0,0,0,0,0,0,0,0,0,1,1,332
1,1,1,1,1,1,0,0,0,0,0,0,0,0,0,0,0,0,0,0,0,0,0,0,0,0,0,0,0,0,0,1,1,334
1,1,1,1,1,1,0,0,0,0,0,0,0,0,0,0,0,0,0,0,0,0,0,0,0,0,0,0,0,0,0,1,1,336
1,1,1,1,1,1,0,0,0,0,0,0,0,0,0,0,0,0,0,0,0,0,0,0,0,0,0,0,0,0,0,1,1,338
1,1,1,1,1,1,0,0,0,0,0,0,0,0,0,0,0,0,0,0,0,0,0,0,0,0,0,0,0,0,0,1,1,340
1,1,1,1,1,1,0,0,0,0,0,0,0,0,0,0,0,0,0,0,0,0,0,0,0,0,0,0,0,0,0,1,1,342
1,1,1,1,1,1,0,0,0,0,0,0,0,0,0,0,0,0,0,0,0,0,0,0,0,0,0,0,0,0,0,1,1,344
1,1,1,1,1,1,0,0,0,0,0,0,0,0,0,0,0,0,0,0,0,0,0,0,0,0,0,0,0,0,0,1,1,346
1,1,1,1,1,1,0,0,0,0,0,0,0,0,0,0,0,0,0,0,0,0,0,0,0,0,0,0,0,0,0,1,1,348
1,1,1,1,1,1,0,0,0,0,0,0,0,0,0,0,0,0,0,0,0,0,0,0,0,0,0,0,0,0,0,1,1,350
1,1,1,1,1,1,0,0,0,0,0,0,0,0,0,0,0,0,0,0,0,0,0,0,0,0,0,0,0,0,0,1,1,352
1,1,1,1,1,1,0,0,0,0,0,0,0,0,0,0,0,0,0,0,0,0,0,0,0,0,0,0,0,0,0,1,1,354
1,1,1,1,1,1,0,0,0,0,0,0,0,0,0,0,0,0,0,0,0,0,0,0,0,0,0,0,0,0,0,1,1,356
1,1,1,1,1,1,0,0,0,0,0,0,0,0,0,0,0,0,0,0,0,0,0,0,0,0,0,0,0,0,0,1,1,358
1,1,1,1,1,1,0,0,0,0,0,0,0,0,0,0,0,0,0,0,0,0,0,0,0,0,0,0,0,0,0,1,1,360
1,1,1,1,1,1,0,0,0,0,0,0,0,0,0,0,0,0,0,0,0,0,0,0,0,0,0,0,0,0,0,1,1,362
1,1,1,1,1,1,0,0,0,0,0,0,0,0,0,0,0,0,0,0,0,0,0,0,0,0,0,0,0,0,0,1,1,364
1,1,1,1,1,1,0,0,0,0,0,0,0,0,0,0,0,0,0,0,0,0,0,0,0,0,0,0,0,0,0,1,1,366
1,1,1,1,1,1,0,0,0,0,0,0,0,0,0,0,0,0,0,0,0,0,0,0,0,0,0,0,0,0,0,1,1,368
1,1,1,1,1,1,0,0,0,0,0,0,0,0,0,0,0,0,0,0,0,0,0,0,0,0,0,0,0,0,0,1,1,370
1,1,1,1,1,1,0,0,0,0,0,0,0,0,0,0,0,0,0,0,0,0,0,0,0,0,0,0,0,0,0,1,1,372
1,1,1,1,1,1,0,0,0,0,0,0,0,0,0,0,0,0,0,0,0,0,0,0,0,0,0,0,0,0,0,1,1,374
1,1,1,1,1,1,0,0,0,0,0,0,0,0,0,0,0,0,0,0,0,0,0,0,0,0,0,0,0,0,0,1,1,376
1,1,1,1,1,1,0,0,0,0,0,0,0,0,0,0,0,0,0,0,0,0,0,0,0,0,0,0,0,0,0,1,1,378
1,1,1,1,1,1,0,0,0,0,0,0,0,0,0,0,0,0,0,0,0,0,0,0,0,0,0,0,0,0,0,1,1,380
1,1,1,1,1,1,0,0,0,0,0,0,0,0,0,0,0,0,0,0,0,0,0,0,0,0,0,0,0,0,0,1,1,382
1,1,1,1,1,1,0,0,0,0,0,0,0,0,0,0,0,0,0,0,0,0,0,0,0,0,0,0,0,0,0,1,1,384
1,1,1,1,1,1,0,0,0,0,0,0,0,0,0,0,0,0,0,0,0,0,0,0,0,0,0,0,0,0,0,1,1,386
1,1,1,1,1,1,0,0,0,0,0,0,0,0,0,0,0,0,0,0,0,0,0,0,0,0,0,0,0,0,0,1,1,388
1,1,1,1,1,1,0,0,0,0,0,0,0,0,0,0,0,0,0,0,0,0,0,0,0,0,0,0,0,0,0,1,1,390
1,1,1,1,1,1,0,0,0,0,0,0,0,0,0,0,0,0,0,0,0,0,0,0,0,0,0,0,0,0,0,1,1,392
1,1,1,1,1,1,0,0,0,0,0,0,0,0,0,0,0,0,0,0,0,0,0,0,0,0,0,0,0,0,0,1,1,394
1,1,1,1,1,1,0,0,0,0,0,0,0,0,0,0,0,0,0,0,0,0,0,0,0,0,0,0,0,0,0,1,1,396
1,1,1,1,1,1,0,0,0,0,0,0,0,0,0,0,0,0,0,0,0,0,0,0,0,0,0,0,0,0,0,1,1,398
1,1,1,1,1,1,0,0,0,0,0,0,0,0,0,0,0,0,0,0,0,0,0,0,0,0,0,0,0,0,0,1,1,400
1,1,1,1,1,1,0,0,0,0,0,0,0,0,0,0,0,0,0,0,0,0,0,0,0,0,0,0,0,0,0,1,1,402
1,1,1,1,1,1,0,0,0,0,0,0,0,0,0,0,0,0,0,0,0,0,0,0,0,0,0,0,0,0,0,1,1,404
1,1,1,1,1,1,0,0,0,0,0,0,0,0,0,0,0,0,0,0,0,0,0,0,0,0,0,0,0,0,0,1,1,406
1,1,1,1,1,1,0,0,0,0,0,0,0,0,0,0,0,0,0,0,0,0,0,0,0,0,0,0,0,0,0,1,1,408
1,1,1,1,1,1,0,0,0,0,0,0,0,0,0,0,0,0,0,0,0,0,0,0,0,0,0,0,0,0,0,1,1,410
1,1,1,1,1,1,0,0,0,0,0,0,0,0,0,0,0,0,0,0,0,0,0,0,0,0,0,0,0,0,0,1,1,412
1,1,1,1,1,1,0,0,0,0,0,0,0,0,0,0,0,0,0,0,0,0,0,0,0,0,0,0,0,0,0,1,1,414
1,1,1,1,1,1,0,0,0,0,0,0,0,0,0,0,0,0,0,0,0,0,0,0,0,0,0,0,0,0,0,1,1,416
1,1,1,1,1,1,0,0,0,0,0,0,0,0,0,0,0,0,0,0,0,0,0,0,0,0,0,0,0,0,0,1,1,418
1,1,1,1,1,1,0,0,0,0,0,0,0,0,0,0,0,0,0,0,0,0,0,0,0,0,0,0,0,0,0,1,1,420
1,1,1,1,1,1,0,0,0,0,0,0,0,0,0,0,0,0,0,0,0,0,0,0,0,0,0,0,0,0,0,1,1,422
1,1,1,1,1,1,0,0,0,0,0,0,0,0,0,0,0,0,0,0,0,0,0,0,0,0,0,0,0,0,0,1,1,424
1,1,1,1,1,1,0,0,0,0,0,0,0,0,0,0,0,0,0,0,0,0,0,0,0,0,0,0,0,0,0,1,1,426
1,1,1,1,1,1,0,0,0,0,0,0,0,0,0,0,0,0,0,0,0,0,0,0,0,0,0,0,0,0,0,1,1,428
1,1,1,1,1,1,0,0,0,0,0,0,0,0,0,0,0,0,0,0,0,0,0,0,0,0,0,0,0,0,0,1,1,430
1,1,1,1,1,1,0,0,0,0,0,0,0,0,0,0,0,0,0,0,0,0,0,0,0,0,0,0,0,0,0,1,1,432
1,1,1,1,1,1,0,0,0,0,0,0,0,0,0,0,0,0,0,0,0,0,0,0,0,0,0,0,0,0,0,1,1,434
1,1,1,1,1,1,0,0,0,0,0,0,0,0,0,0,0,0,0,0,0,0,0,0,0,0,0,0,0,0,0,1,1,436
1,1,1,1,1,1,0,0,0,0,0,0,0,0,0,0,0,0,0,0,0,0,0,0,0,0,0,0,0,0,0,1,1,438
1,1,1,1,1,1,0,0,0,0,0,0,0,0,0,0,0,0,0,0,0,0,0,0,0,0,0,0,0,0,0,1,1,440
1,1,1,1,1,1,0,0,0,0,0,0,0,0,0,0,0,0,0,0,0,0,0,0,0,0,0,0,0,0,0,1,1,442
1,1,1,1,1,1,0,0,0,0,0,0,0,0,0,0,0,0,0,0,0,0,0,0,0,0,0,0,0,0,0,1,1,444
1,1,1,1,1,1,0,0,0,0,0,0,0,0,0,0,0,0,0,0,0,0,0,0,0,0,0,0,0,0,0,1,1,446
1,1,1,1,1,1,0,0,0,0,0,0,0,0,0,0,0,0,0,0,0,0,0,0,0,0,0,0,0,0,0,1,1,448
1,1,1,1,1,1,0,0,0,0,0,0,0,0,0,0,0,0,0,0,0,0,0,0,0,0,0,0,0,0,0,1,1,450
1,1,1,1,1,1,0,0,0,0,0,0,0,0,0,0,0,0,0,0,0,0,0,0,0,0,0,0,0,0,0,1,1,452
1,1,1,1,1,1,0,0,0,0,0,0,0,0,0,0,0,0,0,0,0,0,0,0,0,0,0,0,0,0,0,1,1,454
1,1,1,1,1,1,0,0,0,0,0,0,0,0,0,0,0,0,0,0,0,0,0,0,0,0,0,0,0,0,0,1,1,456
1,1,1,1,1,1,0,0,0,0,0,0,0,0,0,0,0,0,0,0,0,0,0,0,0,0,0,0,0,0,0,1,1,458
1,1,1,1,1,1,0,0,0,0,0,0,0,0,0,0,0,0,0,0,0,0,0,0,0,0,0,0,0,0,0,1,1,460
1,1,1,1,1,1,0,0,0,0,0,0,0,0,0,0,0,0,0,0,0,0,0,0,0,0,0,0,0,0,0,1,1,462
1,1,1,1,1,1,0,0,0,0,0,0,0,0,0,0,0,0,0,0,0,0,0,0,0,0,0,0,0,0,0,1,1,464
1,1,1,1,1,1,0,0,0,0,0,0,0,0,0,0,0,0,0,0,0,0,0,0,0,0,0,0,0,0,0,1,1,466
1,1,1,1,1,1,0,0,0,0,0,0,0,0,0,0,0,0,0,0,0,0,0,0,0,0,0,0,0,0,0,1,1,468
1,1,1,1,1,1,0,0,0,0,0,0,0,0,0,0,0,0,0,0,0,0,0,0,0,0,0,0,0,0,0,1,1,470
1,1,1,1,1,1,0,0,0,0,0,0,0,0,0,0,0,0,0,0,0,0,0,0,0,0,0,0,0,0,0,1,1,472
1,1,1,1,1,1,0,0,0,0,0,0,0,0,0,0,0,0,0,0,0,0,0,0,0,0,0,0,0,0,0,1,1,474
1,1,1,1,1,1,0,0,0,0,0,0,0,0,0,0,0,0,0,0,0,0,0,0,0,0,0,0,0,0,0,1,1,476
1,1,1,1,1,1,0,0,0,0,0,0,0,0,0,0,0,0,0,0,0,0,0,0,0,0,0,0,0,0,0,1,1,478
1,1,1,1,1,1,0,0,0,0,0,0,0,0,0,0,0,0,0,0,0,0,0,0,0,0,0,0,0,0,0,1,1,480
1,1,1,1,1,1,0,0,0,0,0,0,0,0,0,0,0,0,0,0,0,0,0,0,0,0,0,0,0,0,0,1,1,482
1,1,1,1,1,1,0,0,0,0,0,0,0,0,0,0,0,0,0,0,0,0,0,0,0,0,0,0,0,0,0,1,1,484
1,1,1,1,1,1,0,0,0,0,0,0,0,0,0,0,0,0,0,0,0,0,0,0,0,0,0,0,0,0,0,1,1,486
1,1,1,1,1,1,0,0,0,0,0,0,0,0,0,0,0,0,0,0,0,0,0,0,0,0,0,0,0,0,0,1,1,488
1,1,1,1,1,1,0,0,0,0,0,0,0,0,0,0,0,0,0,0,0,0,0,0,0,0,0,0,0,0,0,1,1,490
1,1,1,1,1,1,0,0,0,0,0,0,0,0,0,0,0,0,0,0,0,0,0,0,0,0,0,0,0,0,0,1,1,492
1,1,1,1,1,1,0,0,0,0,0,0,0,0,0,0,0,0,0,0,0,0,0,0,0,0,0,0,0,0,0,1,1,494
1,1,1,1,1,1,0,0,0,0,0,0,0,0,0,0,0,0,0,0,0,0,0,0,0,0,0,0,0,0,0,1,1,496
1,1,1,1,1,1,0,0,0,0,0,0,0,0,0,0,0,0,0,0,0,0,0,0,0,0,0,0,0,0,0,1,1,498
1,1,1,1,1,1,0,0,0,0,0,0,0,0,0,0,0,0,0,0,0,0,0,0,0,0,0,0,0,0,0,1,1,500
1,1,1,1,1,1,0,0,0,0,0,0,0,0,0,0,0,0,0,0,0,0,0,0,0,0,0,0,0,0,0,1,1,502
1,1,1,1,1,1,0,0,0,0,0,0,0,0,0,0,0,0,0,0,0,0,0,0,0,0,0,0,0,0,0,1,1,504
1,1,1,1,1,1,0,0,0,0,0,0,0,0,0,0,0,0,0,0,0,0,0,0,0,0,0,0,0,0,0,1,1,506
1,1,1,1,1,1,0,0,0,0,0,0,0,0,0,0,0,0,0,0,0,0,0,0,0,0,0,0,0,0,0,1,1,508
1,1,1,1,1,1,0,0,0,0,0,0,0,0,0,0,0,0,0,0,0,0,0,0,0,0,0,0,0,0,0,1,1,510
