1016,316,316,316,316,8,308,308,308,308,308,4,0,0,0,0,0,0,0,0,0,0,0,0,0,0,0,0,4,304,0,1016,28,128
1032,445,446,445,445,21,425,426,425,425,425,6,6,6,5,0,0,0,0,0,0,0,0,0,0,0,5,1,1,419,0,1032,28,130
1048,447,447,447,447,10,437,442,437,437,437,5,5,5,5,0,0,0,0,0,0,0,0,0,0,0,5,0,5,432,0,1048,28,132
1064,449,452,449,449,20,432,438,432,432,432,16,16,8,5,0,0,0,0,0,0,0,0,0,0,0,5,3,11,419,0,1064,28,134
1080,451,461,451,451,107,354,354,354,354,354,15,15,15,5,0,0,0,0,0,0,0,0,0,0,0,5,10,0,339,0,1080,28,136
1096,453,472,453,453,114,358,358,358,358,358,24,24,24,5,0,0,0,0,0,0,0,0,0,0,0,5,19,0,334,0,1096,28,138
1112,455,463,455,455,455,8,8,8,8,8,8,8,8,0,0,0,0,0,0,0,0,0,0,0,0,0,8,0,0,0,1112,28,140
1128,457,494,457,457,267,227,227,227,227,227,49,49,45,4,0,0,0,0,0,0,0,0,0,0,0,4,41,4,178,0,1128,28,142
1144,459,533,459,459,323,210,212,210,210,210,80,80,80,6,0,0,0,0,0,0,0,0,0,0,0,6,74,2,130,0,1144,28,144
1160,461,461,461,461,11,450,452,450,450,450,5,5,5,5,0,0,0,0,0,0,0,0,0,0,0,5,0,2,445,0,1160,28,146
1176,463,491,463,463,463,28,28,28,28,28,28,28,28,0,0,0,0,0,0,0,0,0,0,0,0,0,28,0,0,0,1176,28,148
1192,465,467,465,465,20,447,447,447,447,447,13,13,7,5,0,0,0,0,0,0,0,0,0,0,0,5,2,6,434,0,1192,28,150
1208,467,467,467,467,467,0,0,0,0,0,0,0,0,0,0,0,0,0,0,0,0,0,0,0,0,0,0,0,0,0,1208,28,152
1224,469,484,469,469,59,425,428,425,425,425,20,20,20,5,0,0,0,0,0,0,0,0,0,0,0,5,15,3,405,0,1224,28,154
1240,471,471,471,471,33,438,438,438,438,438,10,10,5,5,0,0,0,0,0,0,0,0,0,0,0,5,0,5,428,0,1240,28,156
1256,473,475,473,473,20,455,457,455,455,455,15,15,7,5,0,0,0,0,0,0,0,0,0,0,0,5,2,9,441,0,1256,28,158
1272,475,592,475,475,172,420,424,420,420,420,123,123,123,6,0,0,0,0,0,0,0,0,0,0,0,6,117,4,297,0,1272,28,160
1288,636,636,636,636,13,623,626,623,623,623,6,6,6,6,0,0,0,0,0,0,0,0,0,0,0,6,0,3,617,0,1288,28,162
1304,638,700,638,638,638,62,62,62,62,62,62,62,62,0,0,0,0,0,0,0,0,0,0,0,0,0,62,0,0,0,1304,28,164
1320,640,656,640,640,640,16,16,16,16,16,16,16,16,0,0,0,0,0,0,0,0,0,0,0,0,0,16,0,0,0,1320,28,166
1336,642,688,642,642,642,46,46,46,46,46,46,46,46,0,0,0,0,0,0,0,0,0,0,0,0,0,46,0,0,0,1336,28,168
1352,644,646,644,644,37,609,610,609,609,609,8,8,8,6,0,0,0,0,0,0,0,0,0,0,0,6,2,1,601,0,1352,28,170
1368,646,649,646,646,51,598,599,598,598,598,9,9,9,6,0,0,0,0,0,0,0,0,0,0,0,6,3,1,589,0,1368,28,172
1384,648,648,648,648,12,636,648,636,636,636,12,12,6,6,0,0,0,0,0,0,0,0,0,0,0,6,0,12,630,0,1384,28,174
1400,650,650,650,650,12,638,644,638,638,638,12,12,6,6,0,0,0,0,0,0,0,0,0,0,0,6,0,9,629,0,1400,28,176
1416,652,660,652,652,49,611,613,611,611,611,22,22,14,6,0,0,0,0,0,0,0,0,0,0,0,6,8,10,589,0,1416,28,178
1432,654,656,654,654,39,617,617,617,617,617,8,8,8,6,0,0,0,0,0,0,0,0,0,0,0,6,2,0,609,0,1432,28,180
1448,656,658,656,656,41,617,618,617,617,617,8,8,8,6,0,0,0,0,0,0,0,0,0,0,0,6,2,1,609,0,1448,28,182
1464,658,667,658,658,36,631,635,631,631,631,19,19,15,6,0,0,0,0,0,0,0,0,0,0,0,6,9,8,612,0,1464,28,184
1480,660,685,660,660,216,469,470,469,469,469,30,30,30,5,0,0,0,0,0,0,0,0,0,0,0,5,25,1,439,0,1480,28,186
1496,662,670,662,662,39,631,634,631,631,631,14,14,14,6,0,0,0,0,0,0,0,0,0,0,0,6,8,3,617,0,1496,28,188
1512,664,833,664,664,664,169,169,169,169,169,169,169,169,0,0,0,0,0,0,0,0,0,0,0,0,0,169,0,0,0,1512,28,190
1528,666,669,666,666,18,651,661,651,651,651,14,13,8,5,0,0,0,0,0,0,0,0,0,0,0,5,3,11,642,0,1528,28,192
1544,859,863,859,859,42,821,822,821,821,821,12,12,12,7,0,0,0,0,0,0,0,0,0,0,0,7,5,1,809,0,1544,28,194
1560,861,862,861,861,24,838,840,838,838,838,15,15,9,7,0,0,0,0,0,0,0,0,0,0,0,7,2,7,824,0,1560,28,196
1576,863,883,863,863,863,20,20,20,20,20,20,20,20,0,0,0,0,0,0,0,0,0,0,0,0,0,20,0,0,0,1576,28,198
1592,865,865,865,865,14,851,859,851,851,851,14,14,7,7,0,0,0,0,0,0,0,0,0,0,0,7,0,11,841,0,1592,28,200
1608,867,886,867,867,867,19,19,19,19,19,19,19,19,0,0,0,0,0,0,0,0,0,0,0,0,0,19,0,0,0,1608,28,202
1624,869,876,869,869,73,803,805,803,803,803,27,27,14,7,0,0,0,0,0,0,0,0,0,0,0,7,7,14,777,0,1624,28,204
1640,871,871,871,871,14,857,863,857,857,857,14,14,7,7,0,0,0,0,0,0,0,0,0,0,0,7,0,10,846,0,1640,28,206
1656,873,977,873,873,630,347,348,347,347,347,112,112,112,8,0,0,0,0,0,0,0,0,0,0,0,8,104,1,235,0,1656,28,208
1672,875,881,875,875,56,825,826,825,825,825,18,18,14,7,0,0,0,0,0,0,0,0,0,0,0,7,7,5,807,0,1672,28,210
1688,877,877,877,877,14,863,868,863,863,863,7,7,7,7,0,0,0,0,0,0,0,0,0,0,0,7,0,5,856,0,1688,28,212
1704,879,879,879,879,14,865,867,865,865,865,14,14,7,7,0,0,0,0,0,0,0,0,0,0,0,7,0,8,852,0,1704,28,214
1720,881,881,881,881,14,867,877,867,867,867,14,14,7,7,0,0,0,0,0,0,0,0,0,0,0,7,0,12,858,0,1720,28,216
1736,883,890,883,883,43,847,849,847,847,847,21,21,14,7,0,0,0,0,0,0,0,0,0,0,0,7,7,8,827,0,1736,28,218
1752,885,902,885,885,885,17,17,17,17,17,17,17,17,0,0,0,0,0,0,0,0,0,0,0,0,0,17,0,0,0,1752,28,220
1768,887,887,887,887,14,873,881,873,873,873,14,14,7,7,0,0,0,0,0,0,0,0,0,0,0,7,0,11,863,0,1768,28,222
1784,889,989,889,889,191,798,804,798,798,798,107,107,107,7,0,0,0,0,0,0,0,0,0,0,0,7,100,6,691,0,1784,28,224
1800,1114,1114,1114,1114,17,1097,1099,1097,1097,1097,8,8,8,8,0,0,0,0,0,0,0,0,0,0,0,8,0,2,1089,0,1800,28,226
1816,1116,1116,1116,1116,16,1100,1105,1100,1100,1100,8,8,8,8,0,0,0,0,0,0,0,0,0,0,0,8,0,5,1092,0,1816,28,228
1832,1118,1129,1118,1118,53,1076,1080,1076,1076,1076,19,19,19,8,0,0,0,0,0,0,0,0,0,0,0,8,11,4,1057,0,1832,28,230
1848,1120,1126,1120,1120,1119,7,7,7,7,7,7,7,7,0,0,0,0,0,0,0,0,0,0,0,0,0,7,0,0,0,1848,28,232
1864,1122,1128,1122,1122,48,1080,1081,1080,1080,1080,15,15,15,8,0,0,0,0,0,0,0,0,0,0,0,8,7,1,1065,0,1864,28,234
1880,1124,1132,1124,1124,1124,8,8,8,8,8,8,8,8,0,0,0,0,0,0,0,0,0,0,0,0,0,8,0,0,0,1880,28,236
1896,1126,1134,1126,1126,52,1082,1084,1082,1082,1082,17,17,17,8,0,0,0,0,0,0,0,0,0,0,0,8,9,2,1065,0,1896,28,238
1912,1128,1454,1128,1128,440,1014,1023,1014,1014,1014,338,338,338,12,0,0,0,0,0,0,0,0,0,0,0,12,326,9,676,0,1912,28,240
1928,1130,1143,1130,1130,49,1094,1098,1094,1094,1094,21,21,21,8,0,0,0,0,0,0,0,0,0,0,0,8,13,4,1073,0,1928,28,242
1944,1132,1139,1132,1132,1132,7,7,7,7,7,7,7,7,0,0,0,0,0,0,0,0,0,0,0,0,0,7,0,0,0,1944,28,244
1960,1134,1134,1134,1134,16,1118,1126,1118,1118,1118,16,16,8,8,0,0,0,0,0,0,0,0,0,0,0,8,0,12,1106,0,1960,28,246
1976,1136,1136,1136,1136,16,1120,1125,1120,1120,1120,8,8,8,8,0,0,0,0,0,0,0,0,0,0,0,8,0,5,1112,0,1976,28,248
1992,1138,1154,1138,1138,1138,16,16,16,16,16,16,16,16,0,0,0,0,0,0,0,0,0,0,0,0,0,16,0,0,0,1992,28,250
2008,1140,1191,1140,1140,1140,51,51,51,51,51,51,51,51,0,0,0,0,0,0,0,0,0,0,0,0,0,51,0,0,0,2008,28,252
2024,1142,1142,1142,1142,16,1126,1134,1126,1126,1126,8,8,8,8,0,0,0,0,0,0,0,0,0,0,0,8,0,8,1118,0,2024,28,254
2040,1144,1144,1144,1144,16,1128,1128,1128,1128,1128,8,0,0,0,0,0,0,0,0,0,0,0,0,0,0,0,0,8,1120,0,2040,28,256
2056,1144,1144,1144,1144,16,1128,1136,1128,1128,1128,8,8,8,8,0,0,0,0,0,0,0,0,0,0,0,8,0,8,1120,0,2056,28,258
2072,1144,1145,1144,1144,32,1113,1114,1113,1113,1113,9,9,9,8,0,0,0,0,0,0,0,0,0,0,0,8,1,1,1104,0,2072,28,260
2088,1144,1156,1144,1144,1144,12,12,12,12,12,12,12,12,0,0,0,0,0,0,0,0,0,0,0,0,0,12,0,0,0,2088,28,262
2104,1144,1144,1144,1144,16,1128,1136,1128,1128,1128,8,8,8,8,0,0,0,0,0,0,0,0,0,0,0,8,0,8,1120,0,2104,28,264
2120,1144,1250,1144,1144,1143,107,107,107,107,107,107,107,107,1,0,0,0,0,0,0,0,0,0,0,0,1,106,0,0,0,2120,28,266
2136,1144,1147,1144,1144,32,1115,1121,1115,1115,1115,19,19,11,8,0,0,0,0,0,0,0,0,0,0,0,8,3,11,1099,0,2136,28,268
2152,1144,1156,1144,1144,1144,12,12,12,12,12,12,12,12,0,0,0,0,0,0,0,0,0,0,0,0,0,12,0,0,0,2152,28,270
2168,1144,1156,1144,1144,136,1020,1020,1020,1020,1020,20,20,20,8,0,0,0,0,0,0,0,0,0,0,0,8,12,0,1000,0,2168,28,272
2184,1144,1173,1144,1144,1144,29,29,29,29,29,29,29,29,0,0,0,0,0,0,0,0,0,0,0,0,0,29,0,0,0,2184,28,274
2200,1144,1164,1144,1144,144,1020,1020,1020,1020,1020,28,28,28,8,0,0,0,0,0,0,0,0,0,0,0,8,20,0,992,0,2200,28,276
2216,1144,1149,1144,1144,32,1117,1123,1117,1117,1117,21,21,13,8,0,0,0,0,0,0,0,0,0,0,0,8,5,11,1099,0,2216,28,278
2232,1144,1155,1144,1144,1144,11,11,11,11,11,11,11,11,0,0,0,0,0,0,0,0,0,0,0,0,0,11,0,0,0,2232,28,280
2248,1144,1165,1144,1144,96,1069,1070,1069,1069,1069,29,29,29,8,0,0,0,0,0,0,0,0,0,0,0,8,21,1,1040,0,2248,28,282
2264,1144,1182,1144,1144,354,828,828,828,828,828,45,45,45,7,0,0,0,0,0,0,0,0,0,0,0,7,38,0,783,0,2264,28,284
2280,1144,1144,1144,1144,16,1128,1136,1128,1128,1128,8,8,8,8,0,0,0,0,0,0,0,0,0,0,0,8,0,8,1120,0,2280,28,286
2296,1144,1266,1144,1144,424,842,846,842,842,842,129,129,129,7,0,0,0,0,0,0,0,0,0,0,0,7,122,4,713,0,2296,28,288
2312,1144,1144,1144,1144,16,1128,1131,1128,1128,1128,8,8,8,8,0,0,0,0,0,0,0,0,0,0,0,8,0,3,1120,0,2312,28,290
2328,1144,1144,1144,1144,16,1128,1133,1128,1128,1128,8,8,8,8,0,0,0,0,0,0,0,0,0,0,0,8,0,5,1120,0,2328,28,292
2344,1144,1161,1144,1144,1144,17,17,17,17,17,17,17,17,0,0,0,0,0,0,0,0,0,0,0,0,0,17,0,0,0,2344,28,294
2360,1144,1172,1144,1144,1144,28,28,28,28,28,28,28,28,0,0,0,0,0,0,0,0,0,0,0,0,0,28,0,0,0,2360,28,296
2376,1144,1150,1144,1144,48,1102,1102,1102,1102,1102,14,14,14,8,0,0,0,0,0,0,0,0,0,0,0,8,6,0,1088,0,2376,28,298
2392,1144,1146,1144,1144,32,1114,1114,1114,1114,1114,18,18,10,8,0,0,0,0,0,0,0,0,0,0,0,8,2,8,1096,0,2392,28,300
2408,1144,1181,1144,1144,255,926,926,926,926,926,44,44,44,7,0,0,0,0,0,0,0,0,0,0,0,7,37,0,882,0,2408,28,302
2424,1144,1310,1144,1144,852,458,460,458,458,458,172,172,172,6,0,0,0,0,0,0,0,0,0,0,0,6,166,2,286,0,2424,28,304
2440,1144,1144,1144,1144,48,1096,1098,1096,1096,1096,16,16,8,8,0,0,0,0,0,0,0,0,0,0,0,8,0,9,1081,0,2440,28,306
2456,1144,1166,1144,1144,80,1086,1091,1086,1086,1086,30,30,30,8,0,0,0,0,0,0,0,0,0,0,0,8,22,5,1056,0,2456,28,308
2472,1144,1196,1144,1144,283,913,915,913,913,913,59,59,59,7,0,0,0,0,0,0,0,0,0,0,0,7,52,2,854,0,2472,28,310
2488,1144,1144,1144,1144,48,1096,1096,1096,1096,1096,16,16,8,8,0,0,0,0,0,0,0,0,0,0,0,8,0,8,1080,0,2488,28,312
2504,1144,1144,1144,1144,16,1128,1131,1128,1128,1128,8,8,8,8,0,0,0,0,0,0,0,0,0,0,0,8,0,3,1120,0,2504,28,314
2520,1144,1146,1144,1144,32,1114,1116,1114,1114,1114,18,18,10,8,0,0,0,0,0,0,0,0,0,0,0,8,2,9,1097,0,2520,28,316
2536,1144,1152,1144,1144,1144,8,8,8,8,8,8,8,8,0,0,0,0,0,0,0,0,0,0,0,0,0,8,0,0,0,2536,28,318
2552,1144,1304,1144,1144,240,1064,1071,1064,1064,1064,168,168,168,8,0,0,0,0,0,0,0,0,0,0,0,8,160,7,896,0,2552,28,320
2568,1144,1144,1144,1144,16,1128,1132,1128,1128,1128,8,8,8,8,0,0,0,0,0,0,0,0,0,0,0,8,0,4,1120,0,2568,28,322
2584,1144,1144,1144,1144,16,1128,1131,1128,1128,1128,8,8,8,8,0,0,0,0,0,0,0,0,0,0,0,8,0,3,1120,0,2584,28,324
2600,1144,1190,1144,1144,269,921,922,921,921,921,53,53,53,7,0,0,0,0,0,0,0,0,0,0,0,7,46,1,868,0,2600,28,326
2616,1144,1207,1144,1144,1144,63,63,63,63,63,63,63,63,0,0,0,0,0,0,0,0,0,0,0,0,0,63,0,0,0,2616,28,328
2632,1144,1173,1144,1144,144,1029,1032,1029,1029,1029,37,37,37,8,0,0,0,0,0,0,0,0,0,0,0,8,29,3,992,0,2632,28,330
2648,1144,1162,1144,1144,1144,18,18,18,18,18,18,18,18,0,0,0,0,0,0,0,0,0,0,0,0,0,18,0,0,0,2648,28,332
2664,1144,1155,1144,1144,1144,11,11,11,11,11,11,11,11,0,0,0,0,0,0,0,0,0,0,0,0,0,11,0,0,0,2664,28,334
2680,1144,1432,1144,1144,864,568,570,568,568,568,294,294,294,6,0,0,0,0,0,0,0,0,0,0,0,6,288,2,274,0,2680,28,336
2696,1144,1144,1144,1144,16,1128,1142,1128,1128,1128,16,16,8,8,0,0,0,0,0,0,0,0,0,0,0,8,0,15,1119,0,2696,28,338
2712,1144,1146,1144,1144,48,1098,1099,1098,1098,1098,10,10,10,8,0,0,0,0,0,0,0,0,0,0,0,8,2,1,1088,0,2712,28,340
2728,1144,1144,1144,1144,16,1128,1136,1128,1128,1128,8,8,8,8,0,0,0,0,0,0,0,0,0,0,0,8,0,8,1120,0,2728,28,342
2744,1144,1151,1144,1144,64,1087,1088,1087,1087,1087,15,15,15,8,0,0,0,0,0,0,0,0,0,0,0,8,7,1,1072,0,2744,28,344
2760,1144,1144,1144,1144,16,1128,1136,1128,1128,1128,8,8,8,8,0,0,0,0,0,0,0,0,0,0,0,8,0,8,1120,0,2760,28,346
2776,1144,1144,1144,1144,16,1128,1142,1128,1128,1128,16,16,8,8,0,0,0,0,0,0,0,0,0,0,0,8,0,15,1119,0,2776,28,348
2792,1144,1171,1144,1144,144,1027,1029,1027,1027,1027,35,35,35,8,0,0,0,0,0,0,0,0,0,0,0,8,27,2,992,0,2792,28,350
2808,1144,1144,1144,1144,16,1128,1134,1128,1128,1128,16,16,8,8,0,0,0,0,0,0,0,0,0,0,0,8,0,11,1115,0,2808,28,352
2824,1144,1144,1144,1144,16,1128,1142,1128,1128,1128,16,16,8,8,0,0,0,0,0,0,0,0,0,0,0,8,0,15,1119,0,2824,28,354
2840,1144,1152,1144,1144,64,1088,1090,1088,1088,1088,16,16,16,8,0,0,0,0,0,0,0,0,0,0,0,8,8,2,1072,0,2840,28,356
2856,1144,1153,1144,1144,32,1121,1125,1121,1121,1121,25,25,17,8,0,0,0,0,0,0,0,0,0,0,0,8,9,10,1098,0,2856,28,358
2872,1144,1146,1144,1144,48,1098,1098,1098,1098,1098,10,10,10,8,0,0,0,0,0,0,0,0,0,0,0,8,2,0,1088,0,2872,28,360
2888,1144,1182,1144,1144,1144,38,38,38,38,38,38,38,38,0,0,0,0,0,0,0,0,0,0,0,0,0,38,0,0,0,2888,28,362
2904,1144,1146,1144,1144,48,1098,1099,1098,1098,1098,10,10,10,8,0,0,0,0,0,0,0,0,0,0,0,8,2,1,1088,0,2904,28,364
2920,1144,1149,1144,1144,1144,5,5,5,5,5,5,5,5,0,0,0,0,0,0,0,0,0,0,0,0,0,5,0,0,0,2920,28,366
2936,1144,1154,1144,1144,48,1106,1110,1106,1106,1106,18,18,18,8,0,0,0,0,0,0,0,0,0,0,0,8,10,4,1088,0,2936,28,368
2952,1144,1144,1144,1144,16,1128,1132,1128,1128,1128,16,16,8,8,0,0,0,0,0,0,0,0,0,0,0,8,0,10,1114,0,2952,28,370
2968,1144,1169,1144,1144,255,914,915,914,914,914,32,32,32,7,0,0,0,0,0,0,0,0,0,0,0,7,25,1,882,0,2968,28,372
2984,1144,1146,1144,1144,32,1114,1116,1114,1114,1114,18,18,10,8,0,0,0,0,0,0,0,0,0,0,0,8,2,9,1097,0,2984,28,374
3000,1144,1154,1144,1144,48,1106,1110,1106,1106,1106,18,18,18,8,0,0,0,0,0,0,0,0,0,0,0,8,10,4,1088,0,3000,28,376
3016,1144,1152,1144,1144,32,1120,1124,1120,1120,1120,24,24,16,8,0,0,0,0,0,0,0,0,0,0,0,8,8,10,1098,0,3016,28,378
3032,1144,1204,1144,1144,1144,60,60,60,60,60,60,60,60,0,0,0,0,0,0,0,0,0,0,0,0,0,60,0,0,0,3032,28,380
3048,1144,1217,1144,1144,437,780,780,780,780,780,80,80,80,7,0,0,0,0,0,0,0,0,0,0,0,7,73,0,700,0,3048,28,382
3064,1144,1148,1144,1144,24,1124,1138,1124,1124,1124,19,18,11,7,0,0,0,0,0,0,0,0,0,0,0,7,4,15,1112,0,3064,28,384
3080,1144,1144,1144,1144,16,1128,1134,1128,1128,1128,16,16,8,8,0,0,0,0,0,0,0,0,0,0,0,8,0,11,1115,0,3080,28,386
3096,1144,1148,1144,1144,47,1101,1102,1101,1101,1101,13,13,13,8,0,0,0,0,0,0,0,0,0,0,0,8,5,1,1088,0,3096,28,388
3112,1144,1148,1144,1144,46,1102,1103,1102,1102,1102,14,14,14,8,0,0,0,0,0,0,0,0,0,0,0,8,6,1,1088,0,3112,28,390
3128,1144,1145,1144,1144,24,1121,1123,1121,1121,1121,17,17,9,8,0,0,0,0,0,0,0,0,0,0,0,8,1,9,1105,0,3128,28,392
3144,1144,1144,1144,1144,16,1128,1142,1128,1128,1128,16,16,8,8,0,0,0,0,0,0,0,0,0,0,0,8,0,15,1119,0,3144,28,394
3160,1144,1164,1144,1144,1144,20,20,20,20,20,20,20,20,0,0,0,0,0,0,0,0,0,0,0,0,0,20,0,0,0,3160,28,396
3176,1144,1350,1144,1144,1144,206,206,206,206,206,206,206,206,0,0,0,0,0,0,0,0,0,0,0,0,0,206,0,0,0,3176,28,398
3192,1144,1144,1144,1144,16,1128,1136,1128,1128,1128,16,16,8,8,0,0,0,0,0,0,0,0,0,0,0,8,0,12,1116,0,3192,28,400
3208,1144,1144,1144,1144,16,1128,1130,1128,1128,1128,16,16,8,8,0,0,0,0,0,0,0,0,0,0,0,8,0,9,1113,0,3208,28,402
3224,1144,1164,1144,1144,1144,20,20,20,20,20,20,20,20,0,0,0,0,0,0,0,0,0,0,0,0,0,20,0,0,0,3224,28,404
3240,1144,1152,1144,1144,48,1104,1106,1104,1104,1104,24,24,16,8,0,0,0,0,0,0,0,0,0,0,0,8,8,9,1081,0,3240,28,406
3256,1144,1152,1144,1144,80,1072,1074,1072,1072,1072,24,24,16,8,0,0,0,0,0,0,0,0,0,0,0,8,8,9,1049,0,3256,28,408
3272,1144,1144,1144,1144,16,1128,1140,1128,1128,1128,16,16,8,8,0,0,0,0,0,0,0,0,0,0,0,8,0,14,1118,0,3272,28,410
3288,1144,1144,1144,1144,16,1128,1134,1128,1128,1128,16,16,8,8,0,0,0,0,0,0,0,0,0,0,0,8,0,11,1115,0,3288,28,412
3304,1144,1157,1144,1144,1144,13,13,13,13,13,13,13,13,0,0,0,0,0,0,0,0,0,0,0,0,0,13,0,0,0,3304,28,414
3320,1144,1246,1144,1144,562,684,685,684,684,684,108,108,108,6,0,0,0,0,0,0,0,0,0,0,0,6,102,1,576,0,3320,28,416
3336,1144,1147,1144,1144,48,1099,1100,1099,1099,1099,11,11,11,8,0,0,0,0,0,0,0,0,0,0,0,8,3,1,1088,0,3336,28,418
3352,1144,1150,1144,1144,63,1087,1088,1087,1087,1087,15,15,15,8,0,0,0,0,0,0,0,0,0,0,0,8,7,1,1072,0,3352,28,420
3368,1144,1148,1144,1144,1144,4,4,4,4,4,4,4,4,0,0,0,0,0,0,0,0,0,0,0,0,0,4,0,0,0,3368,28,422
3384,1144,1144,1144,1144,16,1128,1134,1128,1128,1128,8,8,8,8,0,0,0,0,0,0,0,0,0,0,0,8,0,6,1120,0,3384,28,424
3400,1144,1148,1144,1144,1144,4,4,4,4,4,4,4,4,0,0,0,0,0,0,0,0,0,0,0,0,0,4,0,0,0,3400,28,426
3416,1144,1144,1144,1144,16,1128,1130,1128,1128,1128,16,16,8,8,0,0,0,0,0,0,0,0,0,0,0,8,0,9,1113,0,3416,28,428
3432,1144,1144,1144,1144,16,1128,1136,1128,1128,1128,8,8,8,8,0,0,0,0,0,0,0,0,0,0,0,8,0,8,1120,0,3432,28,430
3448,1144,1144,1144,1144,16,1128,1138,1128,1128,1128,16,16,8,8,0,0,0,0,0,0,0,0,0,0,0,8,0,13,1117,0,3448,28,432
3464,1144,1144,1144,1144,16,1128,1140,1128,1128,1128,16,16,8,8,0,0,0,0,0,0,0,0,0,0,0,8,0,14,1118,0,3464,28,434
3480,1144,1151,1144,1144,48,1103,1105,1103,1103,1103,23,23,15,8,0,0,0,0,0,0,0,0,0,0,0,8,7,9,1081,0,3480,28,436
3496,1144,1146,1144,1144,24,1122,1126,1122,1122,1122,18,18,10,8,0,0,0,0,0,0,0,0,0,0,0,8,2,10,1106,0,3496,28,438
3512,1144,1161,1144,1144,1144,17,17,17,17,17,17,17,17,0,0,0,0,0,0,0,0,0,0,0,0,0,17,0,0,0,3512,28,440
3528,1144,1153,1144,1144,62,1091,1092,1091,1091,1091,19,19,19,8,0,0,0,0,0,0,0,0,0,0,0,8,11,1,1072,0,3528,28,442
3544,1144,1144,1144,1144,16,1128,1136,1128,1128,1128,16,16,8,8,0,0,0,0,0,0,0,0,0,0,0,8,0,12,1116,0,3544,28,444
3560,1144,1359,1144,1144,1144,215,215,215,215,215,215,215,215,0,0,0,0,0,0,0,0,0,0,0,0,0,215,0,0,0,3560,28,446
3576,1144,1244,1144,1144,192,1052,1058,1052,1052,1052,108,108,108,8,0,0,0,0,0,0,0,0,0,0,0,8,100,6,944,0,3576,28,448
3592,1144,1144,1144,1144,16,1128,1131,1128,1128,1128,8,8,8,8,0,0,0,0,0,0,0,0,0,0,0,8,0,3,1120,0,3592,28,450
3608,1144,1144,1144,1144,16,1128,1130,1128,1128,1128,8,8,8,8,0,0,0,0,0,0,0,0,0,0,0,8,0,2,1120,0,3608,28,452
3624,1144,1149,1144,1144,1144,5,5,5,5,5,5,5,5,0,0,0,0,0,0,0,0,0,0,0,0,0,5,0,0,0,3624,28,454
3640,1144,1144,1144,1144,16,1128,1133,1128,1128,1128,8,8,8,8,0,0,0,0,0,0,0,0,0,0,0,8,0,5,1120,0,3640,28,456
3656,1144,1144,1144,1144,16,1128,1140,1128,1128,1128,16,16,8,8,0,0,0,0,0,0,0,0,0,0,0,8,0,14,1118,0,3656,28,458
3672,1144,1155,1144,1144,48,1107,1110,1107,1107,1107,19,19,19,8,0,0,0,0,0,0,0,0,0,0,0,8,11,3,1088,0,3672,28,460
3688,1144,1144,1144,1144,16,1128,1140,1128,1128,1128,16,16,8,8,0,0,0,0,0,0,0,0,0,0,0,8,0,14,1118,0,3688,28,462
3704,1144,1236,1144,1144,997,239,239,239,239,239,95,95,95,3,0,0,0,0,0,0,0,0,0,0,0,3,92,0,144,0,3704,28,464
3720,1144,1144,1144,1144,16,1128,1136,1128,1128,1128,8,8,8,8,0,0,0,0,0,0,0,0,0,0,0,8,0,8,1120,0,3720,28,466
3736,1144,1150,1144,1144,47,1103,1104,1103,1103,1103,15,15,15,8,0,0,0,0,0,0,0,0,0,0,0,8,7,1,1088,0,3736,28,468
3752,1144,1144,1144,1144,16,1128,1132,1128,1128,1128,16,16,8,8,0,0,0,0,0,0,0,0,0,0,0,8,0,10,1114,0,3752,28,470
3768,1144,1152,1144,1144,1144,8,8,8,8,8,8,8,8,0,0,0,0,0,0,0,0,0,0,0,0,0,8,0,0,0,3768,28,472
3784,1144,1184,1144,1144,1144,40,40,40,40,40,40,40,40,0,0,0,0,0,0,0,0,0,0,0,0,0,40,0,0,0,3784,28,474
3800,1144,1152,1144,1144,47,1105,1107,1105,1105,1105,17,17,17,8,0,0,0,0,0,0,0,0,0,0,0,8,9,2,1088,0,3800,28,476
3816,1144,1162,1144,1144,1144,18,18,18,18,18,18,18,18,0,0,0,0,0,0,0,0,0,0,0,0,0,18,0,0,0,3816,28,478
3832,1144,1425,1144,1144,367,1058,1064,1058,1058,1058,288,288,288,7,0,0,0,0,0,0,0,0,0,0,0,7,281,6,770,0,3832,28,480
3848,1144,1150,1144,1144,46,1104,1106,1104,1104,1104,16,16,16,8,0,0,0,0,0,0,0,0,0,0,0,8,8,2,1088,0,3848,28,482
3864,1144,1157,1144,1144,48,1109,1113,1109,1109,1109,21,21,21,8,0,0,0,0,0,0,0,0,0,0,0,8,13,4,1088,0,3864,28,484
3880,1144,1171,1144,1144,1144,27,27,27,27,27,27,27,27,0,0,0,0,0,0,0,0,0,0,0,0,0,27,0,0,0,3880,28,486
3896,1144,1151,1144,1144,1144,7,7,7,7,7,7,7,7,0,0,0,0,0,0,0,0,0,0,0,0,0,7,0,0,0,3896,28,488
3912,1144,1211,1144,1144,538,673,673,673,673,673,73,73,73,6,0,0,0,0,0,0,0,0,0,0,0,6,67,0,600,0,3912,28,490
3928,1144,1144,1144,1144,16,1128,1136,1128,1128,1128,16,16,8,8,0,0,0,0,0,0,0,0,0,0,0,8,0,12,1116,0,3928,28,492
3944,1144,1144,1144,1144,16,1128,1140,1128,1128,1128,16,16,8,8,0,0,0,0,0,0,0,0,0,0,0,8,0,14,1118,0,3944,28,494
3960,1144,1144,1144,1144,16,1128,1133,1128,1128,1128,8,8,8,8,0,0,0,0,0,0,0,0,0,0,0,8,0,5,1120,0,3960,28,496
3976,1144,1144,1144,1144,16,1128,1132,1128,1128,1128,16,16,8,8,0,0,0,0,0,0,0,0,0,0,0,8,0,10,1114,0,3976,28,498
3992,1144,1160,1144,1144,1144,16,16,16,16,16,16,16,16,0,0,0,0,0,0,0,0,0,0,0,0,0,16,0,0,0,3992,28,500
4008,1144,1144,1144,1144,16,1128,1131,1128,1128,1128,8,7,7,7,0,0,0,0,0,0,0,0,0,0,0,7,0,4,1120,0,4008,28,502
4024,1144,1195,1144,1144,1144,51,51,51,51,51,51,51,51,0,0,0,0,0,0,0,0,0,0,0,0,0,51,0,0,0,4024,28,504
4040,1144,1156,1144,1144,112,1044,1044,1044,1044,1044,20,20,20,8,0,0,0,0,0,0,0,0,0,0,0,8,12,0,1024,0,4040,28,506
4056,1144,1144,1144,1144,16,1128,1136,1128,1128,1128,8,8,8,8,0,0,0,0,0,0,0,0,0,0,0,8,0,8,1120,0,4056,28,508
4072,1144,1153,1144,1144,62,1091,1092,1091,1091,1091,19,19,19,8,0,0,0,0,0,0,0,0,0,0,0,8,11,1,1072,0,4072,28,510
4088,1144,1144,1144,1144,16,1128,1128,1128,1128,1128,8,0,0,0,0,0,0,0,0,0,0,0,0,0,0,0,0,8,1120,0,4088,28,512
4104,1144,1147,1144,1144,32,1115,1117,1115,1115,1115,11,11,11,8,0,0,0,0,0,0,0,0,0,0,0,8,3,2,1104,0,4104,28,514
4120,1144,1144,1144,1144,16,1128,1136,1128,1128,1128,8,8,8,8,0,0,0,0,0,0,0,0,0,0,0,8,0,8,1120,0,4120,28,516
4136,1144,1156,1144,1144,48,1108,1120,1108,1108,1108,28,28,20,8,0,0,0,0,0,0,0,0,0,0,0,8,12,14,1086,0,4136,28,518
4152,1144,1145,1144,1144,32,1113,1114,1113,1113,1113,9,9,9,8,0,0,0,0,0,0,0,0,0,0,0,8,1,1,1104,0,4152,28,520
4168,1144,1156,1144,1144,48,1108,1115,1108,1108,1108,20,20,20,8,0,0,0,0,0,0,0,0,0,0,0,8,12,7,1088,0,4168,28,522
4184,1144,1156,1144,1144,1144,12,12,12,12,12,12,12,12,0,0,0,0,0,0,0,0,0,0,0,0,0,12,0,0,0,4184,28,524
4200,1144,1175,1144,1144,1144,31,31,31,31,31,31,31,31,0,0,0,0,0,0,0,0,0,0,0,0,0,31,0,0,0,4200,28,526
4216,1144,1144,1144,1144,16,1128,1136,1128,1128,1128,8,8,8,8,0,0,0,0,0,0,0,0,0,0,0,8,0,8,1120,0,4216,28,528
4232,1144,1144,1144,1144,16,1128,1135,1128,1128,1128,8,7,7,7,0,0,0,0,0,0,0,0,0,0,0,7,0,8,1120,0,4232,28,530
4248,1144,1250,1144,1144,1144,106,106,106,106,106,106,106,106,0,0,0,0,0,0,0,0,0,0,0,0,0,106,0,0,0,4248,28,532
4264,1144,1178,1144,1144,128,1050,1053,1050,1050,1050,42,42,42,8,0,0,0,0,0,0,0,0,0,0,0,8,34,3,1008,0,4264,28,534
4280,1144,1147,1144,1144,32,1115,1121,1115,1115,1115,19,19,11,8,0,0,0,0,0,0,0,0,0,0,0,8,3,11,1099,0,4280,28,536
4296,1144,1155,1144,1144,40,1115,1120,1115,1115,1115,19,19,19,8,0,0,0,0,0,0,0,0,0,0,0,8,11,5,1096,0,4296,28,538
4312,1144,1156,1144,1144,1144,12,12,12,12,12,12,12,12,0,0,0,0,0,0,0,0,0,0,0,0,0,12,0,0,0,4312,28,540
4328,1144,1191,1144,1144,176,1015,1019,1015,1015,1015,55,55,55,8,0,0,0,0,0,0,0,0,0,0,0,8,47,4,960,0,4328,28,542
4344,1144,1156,1144,1144,136,1020,1020,1020,1020,1020,20,20,20,8,0,0,0,0,0,0,0,0,0,0,0,8,12,0,1000,0,4344,28,544
4360,1144,1149,1144,1144,48,1101,1103,1101,1101,1101,13,13,13,8,0,0,0,0,0,0,0,0,0,0,0,8,5,2,1088,0,4360,28,546
4376,1144,1173,1144,1144,1144,29,29,29,29,29,29,29,29,0,0,0,0,0,0,0,0,0,0,0,0,0,29,0,0,0,4376,28,548
4392,1144,1223,1144,1144,255,968,972,968,968,968,86,86,86,7,0,0,0,0,0,0,0,0,0,0,0,7,79,4,882,0,4392,28,550
4408,1144,1164,1144,1144,144,1020,1020,1020,1020,1020,28,28,28,8,0,0,0,0,0,0,0,0,0,0,0,8,20,0,992,0,4408,28,552
4424,1144,1177,1144,1144,240,937,938,937,937,937,41,41,41,8,0,0,0,0,0,0,0,0,0,0,0,8,33,1,896,0,4424,28,554
4440,1144,1149,1144,1144,32,1117,1123,1117,1117,1117,21,21,13,8,0,0,0,0,0,0,0,0,0,0,0,8,5,11,1099,0,4440,28,556
4456,1144,1227,1144,1144,478,749,749,749,749,749,89,89,89,6,0,0,0,0,0,0,0,0,0,0,0,6,83,0,660,0,4456,28,558
4472,1144,1259,1144,1144,1086,173,173,173,173,173,117,117,117,2,0,0,0,0,0,0,0,0,0,0,0,2,115,0,56,0,4472,28,560
4488,1144,1156,1144,1144,1144,12,12,12,12,12,12,12,12,0,0,0,0,0,0,0,0,0,0,0,0,0,12,0,0,0,4488,28,562
4504,1144,1165,1144,1144,96,1069,1070,1069,1069,1069,29,29,29,8,0,0,0,0,0,0,0,0,0,0,0,8,21,1,1040,0,4504,28,564
4520,1144,1152,1144,1144,1144,8,8,8,8,8,8,8,8,0,0,0,0,0,0,0,0,0,0,0,0,0,8,0,0,0,4520,28,566
4536,1144,1182,1144,1144,339,843,843,843,843,843,45,45,45,7,0,0,0,0,0,0,0,0,0,0,0,7,38,0,798,0,4536,28,568
4552,1144,1167,1144,1144,80,1087,1091,1087,1087,1087,31,31,31,8,0,0,0,0,0,0,0,0,0,0,0,8,23,4,1056,0,4552,28,570
4568,1144,1144,1144,1144,16,1128,1136,1128,1128,1128,8,8,8,8,0,0,0,0,0,0,0,0,0,0,0,8,0,8,1120,0,4568,28,572
4584,1144,1171,1144,1144,1144,27,27,27,27,27,27,27,27,0,0,0,0,0,0,0,0,0,0,0,0,0,27,0,0,0,4584,28,574
4600,1144,1266,1144,1144,409,857,861,857,857,857,129,129,129,7,0,0,0,0,0,0,0,0,0,0,0,7,122,4,728,0,4600,28,576
4616,1144,1277,1144,1144,1144,133,133,133,133,133,133,133,133,0,0,0,0,0,0,0,0,0,0,0,0,0,133,0,0,0,4616,28,578
4632,1144,1144,1144,1144,16,1128,1131,1128,1128,1128,8,8,8,8,0,0,0,0,0,0,0,0,0,0,0,8,0,3,1120,0,4632,28,580
4648,1144,1165,1144,1144,1144,21,21,21,21,21,21,21,21,0,0,0,0,0,0,0,0,0,0,0,0,0,21,0,0,0,4648,28,582
4664,1144,1144,1144,1144,16,1128,1133,1128,1128,1128,8,8,8,8,0,0,0,0,0,0,0,0,0,0,0,8,0,5,1120,0,4664,28,584
4680,1144,1151,1144,1144,1144,7,7,7,7,7,7,7,7,0,0,0,0,0,0,0,0,0,0,0,0,0,7,0,0,0,4680,28,586
4696,1144,1161,1144,1144,1144,17,17,17,17,17,17,17,17,0,0,0,0,0,0,0,0,0,0,0,0,0,17,0,0,0,4696,28,588
4712,1144,1187,1144,1144,208,979,981,979,979,979,51,51,51,8,0,0,0,0,0,0,0,0,0,0,0,8,43,2,928,0,4712,28,590
4728,1144,1282,1144,1144,1110,172,172,172,172,172,140,140,140,2,0,0,0,0,0,0,0,0,0,0,0,2,138,0,32,0,4728,28,592
4744,1144,1153,1144,1144,1144,9,9,9,9,9,9,9,9,0,0,0,0,0,0,0,0,0,0,0,0,0,9,0,0,0,4744,28,594
4760,1144,1150,1144,1144,48,1102,1102,1102,1102,1102,14,14,14,8,0,0,0,0,0,0,0,0,0,0,0,8,6,0,1088,0,4760,28,596
4776,1144,1146,1144,1144,1144,2,2,2,2,2,2,2,2,0,0,0,0,0,0,0,0,0,0,0,0,0,2,0,0,0,4776,28,598
4792,1144,1146,1144,1144,32,1114,1114,1114,1114,1114,18,18,10,8,0,0,0,0,0,0,0,0,0,0,0,8,2,8,1096,0,4792,28,600
4808,1144,1148,1144,1144,32,1116,1118,1116,1116,1116,12,12,12,8,0,0,0,0,0,0,0,0,0,0,0,8,4,2,1104,0,4808,28,602




248,31,31,31,31,2,29,29,29,29,29,1,0,0,0,0,0,0,0,0,0,0,0,0,0,0,0,0,1,28,0,248,28,32
264,64,72,64,64,62,10,10,10,10,10,10,10,10,2,0,0,0,0,0,0,0,0,0,0,0,2,8,0,0,0,264,28,34
280,66,68,66,66,66,2,2,2,2,2,2,2,2,0,0,0,0,0,0,0,0,0,0,0,0,0,2,0,0,0,280,28,36
296,68,83,68,68,67,16,16,16,16,16,16,16,16,1,0,0,0,0,0,0,0,0,0,0,0,1,15,0,0,0,296,28,38
312,70,78,70,70,70,8,8,8,8,8,8,8,8,0,0,0,0,0,0,0,0,0,0,0,0,0,8,0,0,0,312,28,40
328,72,72,72,72,72,0,0,0,0,0,0,0,0,0,0,0,0,0,0,0,0,0,0,0,0,0,0,0,0,0,328,28,42
344,74,74,74,74,4,70,74,70,70,70,5,5,2,2,0,0,0,0,0,0,0,0,0,0,0,2,0,5,67,0,344,28,44
360,76,78,76,76,17,61,62,61,61,61,4,4,4,2,0,0,0,0,0,0,0,0,0,0,0,2,2,1,57,0,360,28,46
376,78,80,78,78,6,74,78,74,74,74,6,6,4,2,0,0,0,0,0,0,0,0,0,0,0,2,2,4,70,0,376,28,48
392,80,80,80,80,5,75,77,75,75,75,4,4,2,2,0,0,0,0,0,0,0,0,0,0,0,2,0,3,72,0,392,28,50
408,82,88,82,82,82,6,6,6,6,6,6,6,6,0,0,0,0,0,0,0,0,0,0,0,0,0,6,0,0,0,408,28,52
424,84,84,84,84,4,80,84,80,80,80,4,4,2,2,0,0,0,0,0,0,0,0,0,0,0,2,0,4,78,0,424,28,54
440,86,143,86,86,68,75,78,75,75,75,62,62,62,5,0,0,0,0,0,0,0,0,0,0,0,5,57,3,13,0,440,28,56
456,88,94,88,88,88,6,6,6,6,6,6,6,6,0,0,0,0,0,0,0,0,0,0,0,0,0,6,0,0,0,456,28,58
472,90,140,90,90,89,51,51,51,51,51,51,51,51,1,0,0,0,0,0,0,0,0,0,0,0,1,50,0,0,0,472,28,60
488,92,92,92,92,4,88,89,88,88,88,2,2,2,2,0,0,0,0,0,0,0,0,0,0,0,2,0,1,86,0,488,28,62
504,94,94,94,94,4,90,90,90,90,90,2,0,0,0,0,0,0,0,0,0,0,0,0,0,0,0,0,2,88,0,504,28,64
520,159,159,159,159,7,152,154,152,152,152,3,3,3,3,0,0,0,0,0,0,0,0,0,0,0,3,0,2,149,0,520,28,66
536,161,169,161,161,69,100,100,100,100,100,11,11,11,3,0,0,0,0,0,0,0,0,0,0,0,3,8,0,89,0,536,28,68
552,163,168,163,163,163,5,5,5,5,5,5,5,5,0,0,0,0,0,0,0,0,0,0,0,0,0,5,0,0,0,552,28,70
568,165,187,165,165,165,22,22,22,22,22,22,22,22,0,0,0,0,0,0,0,0,0,0,0,0,0,22,0,0,0,568,28,72
584,167,194,167,167,165,29,29,29,29,29,29,29,29,2,0,0,0,0,0,0,0,0,0,0,0,2,27,0,0,0,584,28,74
600,169,169,169,169,169,0,0,0,0,0,0,0,0,0,0,0,0,0,0,0,0,0,0,0,0,0,0,0,0,0,600,28,76
616,171,171,171,171,23,148,148,148,148,148,6,6,3,3,0,0,0,0,0,0,0,0,0,0,0,3,0,3,142,0,616,28,78
632,173,249,173,173,117,132,135,132,132,132,82,82,82,6,0,0,0,0,0,0,0,0,0,0,0,6,76,3,50,0,632,28,80
648,175,202,175,175,175,27,27,27,27,27,27,27,27,0,0,0,0,0,0,0,0,0,0,0,0,0,27,0,0,0,648,28,82
664,177,178,177,177,177,1,1,1,1,1,1,1,1,0,0,0,0,0,0,0,0,0,0,0,0,0,1,0,0,0,664,28,84
680,179,182,179,179,29,153,154,153,153,153,6,6,6,3,0,0,0,0,0,0,0,0,0,0,0,3,3,1,147,0,680,28,86
696,181,181,181,181,6,175,181,175,175,175,6,6,3,3,0,0,0,0,0,0,0,0,0,0,0,3,0,6,172,0,696,28,88
712,183,185,183,183,19,166,166,166,166,166,5,5,5,3,0,0,0,0,0,0,0,0,0,0,0,3,2,0,161,0,712,28,90
728,185,191,185,185,21,170,172,170,170,170,9,9,9,3,0,0,0,0,0,0,0,0,0,0,0,3,6,2,161,0,728,28,92
744,187,190,187,187,23,167,168,167,167,167,6,6,6,3,0,0,0,0,0,0,0,0,0,0,0,3,3,1,161,0,744,28,94
760,189,191,189,189,9,182,188,182,182,182,8,8,5,3,0,0,0,0,0,0,0,0,0,0,0,3,2,6,177,0,760,28,96
776,286,287,286,286,13,274,276,274,274,274,9,9,6,4,0,0,0,0,0,0,0,0,0,0,0,4,2,4,266,0,776,28,98
792,288,288,288,288,8,280,284,280,280,280,9,9,4,4,0,0,0,0,0,0,0,0,0,0,0,4,0,7,273,0,792,28,100
808,290,293,290,290,45,248,248,248,248,248,11,11,8,4,0,0,0,0,0,0,0,0,0,0,0,4,4,3,237,0,808,28,102
824,292,300,292,292,292,8,8,8,8,8,8,8,8,0,0,0,0,0,0,0,0,0,0,0,0,0,8,0,0,0,824,28,104
840,294,294,294,294,9,285,286,285,285,285,4,4,4,4,0,0,0,0,0,0,0,0,0,0,0,4,0,1,281,0,840,28,106
856,296,296,296,296,8,288,294,288,288,288,11,11,4,4,0,0,0,0,0,0,0,0,0,0,0,4,0,10,280,0,856,28,108
872,298,315,298,298,298,17,17,17,17,17,17,17,17,0,0,0,0,0,0,0,0,0,0,0,0,0,17,0,0,0,872,28,110
888,300,384,300,300,123,261,266,261,261,261,91,91,91,7,0,0,0,0,0,0,0,0,0,0,0,7,84,5,170,0,888,28,112
904,302,302,302,302,9,293,294,293,293,293,4,4,4,4,0,0,0,0,0,0,0,0,0,0,0,4,0,1,289,0,904,28,114
920,304,310,304,304,304,6,6,6,6,6,6,6,6,0,0,0,0,0,0,0,0,0,0,0,0,0,6,0,0,0,920,28,116
936,306,308,306,306,306,2,2,2,2,2,2,2,2,0,0,0,0,0,0,0,0,0,0,0,0,0,2,0,0,0,936,28,118
952,308,473,308,308,242,231,234,231,231,231,171,171,171,6,0,0,0,0,0,0,0,0,0,0,0,6,165,3,60,0,952,28,120
968,310,314,310,310,310,4,4,4,4,4,4,4,4,0,0,0,0,0,0,0,0,0,0,0,0,0,4,0,0,0,968,28,122
984,312,312,312,312,8,304,306,304,304,304,4,4,4,4,0,0,0,0,0,0,0,0,0,0,0,4,0,2,300,0,984,28,124
1000,314,349,314,314,314,35,35,35,35,35,35,35,35,0,0,0,0,0,0,0,0,0,0,0,0,0,35,0,0,0,1000,28,126
1016,316,316,316,316,8,308,308,308,308,308,4,0,0,0,0,0,0,0,0,0,0,0,0,0,0,0,0,4,304,0,1016,28,128
1032,445,446,445,445,21,425,426,425,425,425,6,6,6,5,0,0,0,0,0,0,0,0,0,0,0,5,1,1,419,0,1032,28,130
1048,447,447,447,447,10,437,442,437,437,437,5,5,5,5,0,0,0,0,0,0,0,0,0,0,0,5,0,5,432,0,1048,28,132
1064,449,452,449,449,20,432,438,432,432,432,16,16,8,5,0,0,0,0,0,0,0,0,0,0,0,5,3,11,419,0,1064,28,134
1080,451,461,451,451,107,354,354,354,354,354,15,15,15,5,0,0,0,0,0,0,0,0,0,0,0,5,10,0,339,0,1080,28,136
1096,453,472,453,453,114,358,358,358,358,358,24,24,24,5,0,0,0,0,0,0,0,0,0,0,0,5,19,0,334,0,1096,28,138
1112,455,463,455,455,455,8,8,8,8,8,8,8,8,0,0,0,0,0,0,0,0,0,0,0,0,0,8,0,0,0,1112,28,140
1128,457,494,457,457,267,227,227,227,227,227,49,49,45,4,0,0,0,0,0,0,0,0,0,0,0,4,41,4,178,0,1128,28,142
1144,459,533,459,459,323,210,212,210,210,210,80,80,80,6,0,0,0,0,0,0,0,0,0,0,0,6,74,2,130,0,1144,28,144
1160,461,461,461,461,11,450,452,450,450,450,5,5,5,5,0,0,0,0,0,0,0,0,0,0,0,5,0,2,445,0,1160,28,146
1176,463,491,463,463,463,28,28,28,28,28,28,28,28,0,0,0,0,0,0,0,0,0,0,0,0,0,28,0,0,0,1176,28,148
1192,465,467,465,465,20,447,447,447,447,447,13,13,7,5,0,0,0,0,0,0,0,0,0,0,0,5,2,6,434,0,1192,28,150
1208,467,467,467,467,467,0,0,0,0,0,0,0,0,0,0,0,0,0,0,0,0,0,0,0,0,0,0,0,0,0,1208,28,152
1224,469,484,469,469,59,425,428,425,425,425,20,20,20,5,0,0,0,0,0,0,0,0,0,0,0,5,15,3,405,0,1224,28,154
1240,471,471,471,471,33,438,438,438,438,438,10,10,5,5,0,0,0,0,0,0,0,0,0,0,0,5,0,5,428,0,1240,28,156
1256,473,475,473,473,20,455,457,455,455,455,15,15,7,5,0,0,0,0,0,0,0,0,0,0,0,5,2,9,441,0,1256,28,158
1272,475,592,475,475,172,420,424,420,420,420,123,123,123,6,0,0,0,0,0,0,0,0,0,0,0,6,117,4,297,0,1272,28,160
1288,636,636,636,636,13,623,626,623,623,623,6,6,6,6,0,0,0,0,0,0,0,0,0,0,0,6,0,3,617,0,1288,28,162
1304,638,700,638,638,638,62,62,62,62,62,62,62,62,0,0,0,0,0,0,0,0,0,0,0,0,0,62,0,0,0,1304,28,164
1320,640,656,640,640,640,16,16,16,16,16,16,16,16,0,0,0,0,0,0,0,0,0,0,0,0,0,16,0,0,0,1320,28,166
1336,642,688,642,642,642,46,46,46,46,46,46,46,46,0,0,0,0,0,0,0,0,0,0,0,0,0,46,0,0,0,1336,28,168
1352,644,646,644,644,37,609,610,609,609,609,8,8,8,6,0,0,0,0,0,0,0,0,0,0,0,6,2,1,601,0,1352,28,170
1368,646,649,646,646,51,598,599,598,598,598,9,9,9,6,0,0,0,0,0,0,0,0,0,0,0,6,3,1,589,0,1368,28,172
1384,648,648,648,648,12,636,648,636,636,636,12,12,6,6,0,0,0,0,0,0,0,0,0,0,0,6,0,12,630,0,1384,28,174
1400,650,650,650,650,12,638,644,638,638,638,12,12,6,6,0,0,0,0,0,0,0,0,0,0,0,6,0,9,629,0,1400,28,176
1416,652,660,652,652,49,611,613,611,611,611,22,22,14,6,0,0,0,0,0,0,0,0,0,0,0,6,8,10,589,0,1416,28,178
1432,654,656,654,654,39,617,617,617,617,617,8,8,8,6,0,0,0,0,0,0,0,0,0,0,0,6,2,0,609,0,1432,28,180
1448,656,658,656,656,41,617,618,617,617,617,8,8,8,6,0,0,0,0,0,0,0,0,0,0,0,6,2,1,609,0,1448,28,182
1464,658,667,658,658,36,631,635,631,631,631,19,19,15,6,0,0,0,0,0,0,0,0,0,0,0,6,9,8,612,0,1464,28,184
1480,660,685,660,660,216,469,470,469,469,469,30,30,30,5,0,0,0,0,0,0,0,0,0,0,0,5,25,1,439,0,1480,28,186
1496,662,670,662,662,39,631,634,631,631,631,14,14,14,6,0,0,0,0,0,0,0,0,0,0,0,6,8,3,617,0,1496,28,188
1512,664,833,664,664,664,169,169,169,169,169,169,169,169,0,0,0,0,0,0,0,0,0,0,0,0,0,169,0,0,0,1512,28,190
1528,666,669,666,666,18,651,661,651,651,651,14,13,8,5,0,0,0,0,0,0,0,0,0,0,0,5,3,11,642,0,1528,28,192
1544,859,863,859,859,42,821,822,821,821,821,12,12,12,7,0,0,0,0,0,0,0,0,0,0,0,7,5,1,809,0,1544,28,194
1560,861,862,861,861,24,838,840,838,838,838,15,15,9,7,0,0,0,0,0,0,0,0,0,0,0,7,2,7,824,0,1560,28,196
1576,863,883,863,863,863,20,20,20,20,20,20,20,20,0,0,0,0,0,0,0,0,0,0,0,0,0,20,0,0,0,1576,28,198
1592,865,865,865,865,14,851,859,851,851,851,14,14,7,7,0,0,0,0,0,0,0,0,0,0,0,7,0,11,841,0,1592,28,200
1608,867,886,867,867,867,19,19,19,19,19,19,19,19,0,0,0,0,0,0,0,0,0,0,0,0,0,19,0,0,0,1608,28,202
1624,869,876,869,869,73,803,805,803,803,803,27,27,14,7,0,0,0,0,0,0,0,0,0,0,0,7,7,14,777,0,1624,28,204
1640,871,871,871,871,14,857,863,857,857,857,14,14,7,7,0,0,0,0,0,0,0,0,0,0,0,7,0,10,846,0,1640,28,206
1656,873,977,873,873,630,347,348,347,347,347,112,112,112,8,0,0,0,0,0,0,0,0,0,0,0,8,104,1,235,0,1656,28,208
1672,875,881,875,875,56,825,826,825,825,825,18,18,14,7,0,0,0,0,0,0,0,0,0,0,0,7,7,5,807,0,1672,28,210
1688,877,877,877,877,14,863,868,863,863,863,7,7,7,7,0,0,0,0,0,0,0,0,0,0,0,7,0,5,856,0,1688,28,212
1704,879,879,879,879,14,865,867,865,865,865,14,14,7,7,0,0,0,0,0,0,0,0,0,0,0,7,0,8,852,0,1704,28,214
1720,881,881,881,881,14,867,877,867,867,867,14,14,7,7,0,0,0,0,0,0,0,0,0,0,0,7,0,12,858,0,1720,28,216
1736,883,890,883,883,43,847,849,847,847,847,21,21,14,7,0,0,0,0,0,0,0,0,0,0,0,7,7,8,827,0,1736,28,218
1752,885,902,885,885,885,17,17,17,17,17,17,17,17,0,0,0,0,0,0,0,0,0,0,0,0,0,17,0,0,0,1752,28,220
1768,887,887,887,887,14,873,881,873,873,873,14,14,7,7,0,0,0,0,0,0,0,0,0,0,0,7,0,11,863,0,1768,28,222
1784,889,989,889,889,191,798,804,798,798,798,107,107,107,7,0,0,0,0,0,0,0,0,0,0,0,7,100,6,691,0,1784,28,224
1800,1114,1114,1114,1114,17,1097,1099,1097,1097,1097,8,8,8,8,0,0,0,0,0,0,0,0,0,0,0,8,0,2,1089,0,1800,28,226
1816,1116,1116,1116,1116,16,1100,1105,1100,1100,1100,8,8,8,8,0,0,0,0,0,0,0,0,0,0,0,8,0,5,1092,0,1816,28,228
1832,1118,1129,1118,1118,53,1076,1080,1076,1076,1076,19,19,19,8,0,0,0,0,0,0,0,0,0,0,0,8,11,4,1057,0,1832,28,230
1848,1120,1126,1120,1120,1119,7,7,7,7,7,7,7,7,0,0,0,0,0,0,0,0,0,0,0,0,0,7,0,0,0,1848,28,232
1864,1122,1128,1122,1122,48,1080,1081,1080,1080,1080,15,15,15,8,0,0,0,0,0,0,0,0,0,0,0,8,7,1,1065,0,1864,28,234
1880,1124,1132,1124,1124,1124,8,8,8,8,8,8,8,8,0,0,0,0,0,0,0,0,0,0,0,0,0,8,0,0,0,1880,28,236
1896,1126,1134,1126,1126,52,1082,1084,1082,1082,1082,17,17,17,8,0,0,0,0,0,0,0,0,0,0,0,8,9,2,1065,0,1896,28,238
1912,1128,1454,1128,1128,440,1014,1023,1014,1014,1014,338,338,338,12,0,0,0,0,0,0,0,0,0,0,0,12,326,9,676,0,1912,28,240
1928,1130,1143,1130,1130,49,1094,1098,1094,1094,1094,21,21,21,8,0,0,0,0,0,0,0,0,0,0,0,8,13,4,1073,0,1928,28,242
1944,1132,1139,1132,1132,1132,7,7,7,7,7,7,7,7,0,0,0,0,0,0,0,0,0,0,0,0,0,7,0,0,0,1944,28,244
1960,1134,1134,1134,1134,16,1118,1126,1118,1118,1118,16,16,8,8,0,0,0,0,0,0,0,0,0,0,0,8,0,12,1106,0,1960,28,246
1976,1136,1136,1136,1136,16,1120,1125,1120,1120,1120,8,8,8,8,0,0,0,0,0,0,0,0,0,0,0,8,0,5,1112,0,1976,28,248
1992,1138,1154,1138,1138,1138,16,16,16,16,16,16,16,16,0,0,0,0,0,0,0,0,0,0,0,0,0,16,0,0,0,1992,28,250
2008,1140,1191,1140,1140,1140,51,51,51,51,51,51,51,51,0,0,0,0,0,0,0,0,0,0,0,0,0,51,0,0,0,2008,28,252
2024,1142,1142,1142,1142,16,1126,1134,1126,1126,1126,8,8,8,8,0,0,0,0,0,0,0,0,0,0,0,8,0,8,1118,0,2024,28,254
2040,1144,1144,1144,1144,16,1128,1128,1128,1128,1128,8,0,0,0,0,0,0,0,0,0,0,0,0,0,0,0,0,8,1120,0,2040,28,256
2056,1144,1144,1144,1144,16,1128,1136,1128,1128,1128,8,8,8,8,0,0,0,0,0,0,0,0,0,0,0,8,0,8,1120,0,2056,28,258
2072,1144,1145,1144,1144,32,1113,1114,1113,1113,1113,9,9,9,8,0,0,0,0,0,0,0,0,0,0,0,8,1,1,1104,0,2072,28,260
2088,1144,1156,1144,1144,1144,12,12,12,12,12,12,12,12,0,0,0,0,0,0,0,0,0,0,0,0,0,12,0,0,0,2088,28,262
2104,1144,1144,1144,1144,16,1128,1136,1128,1128,1128,8,8,8,8,0,0,0,0,0,0,0,0,0,0,0,8,0,8,1120,0,2104,28,264
2120,1144,1250,1144,1144,1143,107,107,107,107,107,107,107,107,1,0,0,0,0,0,0,0,0,0,0,0,1,106,0,0,0,2120,28,266
2136,1144,1147,1144,1144,32,1115,1121,1115,1115,1115,19,19,11,8,0,0,0,0,0,0,0,0,0,0,0,8,3,11,1099,0,2136,28,268
2152,1144,1156,1144,1144,1144,12,12,12,12,12,12,12,12,0,0,0,0,0,0,0,0,0,0,0,0,0,12,0,0,0,2152,28,270
2168,1144,1156,1144,1144,136,1020,1020,1020,1020,1020,20,20,20,8,0,0,0,0,0,0,0,0,0,0,0,8,12,0,1000,0,2168,28,272
2184,1144,1173,1144,1144,1144,29,29,29,29,29,29,29,29,0,0,0,0,0,0,0,0,0,0,0,0,0,29,0,0,0,2184,28,274
2200,1144,1164,1144,1144,144,1020,1020,1020,1020,1020,28,28,28,8,0,0,0,0,0,0,0,0,0,0,0,8,20,0,992,0,2200,28,276
2216,1144,1149,1144,1144,32,1117,1123,1117,1117,1117,21,21,13,8,0,0,0,0,0,0,0,0,0,0,0,8,5,11,1099,0,2216,28,278
2232,1144,1155,1144,1144,1144,11,11,11,11,11,11,11,11,0,0,0,0,0,0,0,0,0,0,0,0,0,11,0,0,0,2232,28,280
2248,1144,1165,1144,1144,96,1069,1070,1069,1069,1069,29,29,29,8,0,0,0,0,0,0,0,0,0,0,0,8,21,1,1040,0,2248,28,282
2264,1144,1182,1144,1144,354,828,828,828,828,828,45,45,45,7,0,0,0,0,0,0,0,0,0,0,0,7,38,0,783,0,2264,28,284
2280,1144,1144,1144,1144,16,1128,1136,1128,1128,1128,8,8,8,8,0,0,0,0,0,0,0,0,0,0,0,8,0,8,1120,0,2280,28,286
2296,1144,1266,1144,1144,424,842,846,842,842,842,129,129,129,7,0,0,0,0,0,0,0,0,0,0,0,7,122,4,713,0,2296,28,288
2312,1144,1144,1144,1144,16,1128,1131,1128,1128,1128,8,8,8,8,0,0,0,0,0,0,0,0,0,0,0,8,0,3,1120,0,2312,28,290
2328,1144,1144,1144,1144,16,1128,1133,1128,1128,1128,8,8,8,8,0,0,0,0,0,0,0,0,0,0,0,8,0,5,1120,0,2328,28,292
2344,1144,1161,1144,1144,1144,17,17,17,17,17,17,17,17,0,0,0,0,0,0,0,0,0,0,0,0,0,17,0,0,0,2344,28,294
2360,1144,1172,1144,1144,1144,28,28,28,28,28,28,28,28,0,0,0,0,0,0,0,0,0,0,0,0,0,28,0,0,0,2360,28,296
2376,1144,1150,1144,1144,48,1102,1102,1102,1102,1102,14,14,14,8,0,0,0,0,0,0,0,0,0,0,0,8,6,0,1088,0,2376,28,298
2392,1144,1146,1144,1144,32,1114,1114,1114,1114,1114,18,18,10,8,0,0,0,0,0,0,0,0,0,0,0,8,2,8,1096,0,2392,28,300
2408,1144,1181,1144,1144,255,926,926,926,926,926,44,44,44,7,0,0,0,0,0,0,0,0,0,0,0,7,37,0,882,0,2408,28,302
2424,1144,1310,1144,1144,852,458,460,458,458,458,172,172,172,6,0,0,0,0,0,0,0,0,0,0,0,6,166,2,286,0,2424,28,304
2440,1144,1144,1144,1144,48,1096,1098,1096,1096,1096,16,16,8,8,0,0,0,0,0,0,0,0,0,0,0,8,0,9,1081,0,2440,28,306
2456,1144,1166,1144,1144,80,1086,1091,1086,1086,1086,30,30,30,8,0,0,0,0,0,0,0,0,0,0,0,8,22,5,1056,0,2456,28,308
2472,1144,1196,1144,1144,283,913,915,913,913,913,59,59,59,7,0,0,0,0,0,0,0,0,0,0,0,7,52,2,854,0,2472,28,310
2488,1144,1144,1144,1144,48,1096,1096,1096,1096,1096,16,16,8,8,0,0,0,0,0,0,0,0,0,0,0,8,0,8,1080,0,2488,28,312
2504,1144,1144,1144,1144,16,1128,1131,1128,1128,1128,8,8,8,8,0,0,0,0,0,0,0,0,0,0,0,8,0,3,1120,0,2504,28,314
2520,1144,1146,1144,1144,32,1114,1116,1114,1114,1114,18,18,10,8,0,0,0,0,0,0,0,0,0,0,0,8,2,9,1097,0,2520,28,316
2536,1144,1152,1144,1144,1144,8,8,8,8,8,8,8,8,0,0,0,0,0,0,0,0,0,0,0,0,0,8,0,0,0,2536,28,318
2552,1144,1304,1144,1144,240,1064,1071,1064,1064,1064,168,168,168,8,0,0,0,0,0,0,0,0,0,0,0,8,160,7,896,0,2552,28,320
2568,1144,1144,1144,1144,16,1128,1132,1128,1128,1128,8,8,8,8,0,0,0,0,0,0,0,0,0,0,0,8,0,4,1120,0,2568,28,322
2584,1144,1144,1144,1144,16,1128,1131,1128,1128,1128,8,8,8,8,0,0,0,0,0,0,0,0,0,0,0,8,0,3,1120,0,2584,28,324
2600,1144,1190,1144,1144,269,921,922,921,921,921,53,53,53,7,0,0,0,0,0,0,0,0,0,0,0,7,46,1,868,0,2600,28,326
2616,1144,1207,1144,1144,1144,63,63,63,63,63,63,63,63,0,0,0,0,0,0,0,0,0,0,0,0,0,63,0,0,0,2616,28,328
2632,1144,1173,1144,1144,144,1029,1032,1029,1029,1029,37,37,37,8,0,0,0,0,0,0,0,0,0,0,0,8,29,3,992,0,2632,28,330
2648,1144,1162,1144,1144,1144,18,18,18,18,18,18,18,18,0,0,0,0,0,0,0,0,0,0,0,0,0,18,0,0,0,2648,28,332
2664,1144,1155,1144,1144,1144,11,11,11,11,11,11,11,11,0,0,0,0,0,0,0,0,0,0,0,0,0,11,0,0,0,2664,28,334
2680,1144,1432,1144,1144,864,568,570,568,568,568,294,294,294,6,0,0,0,0,0,0,0,0,0,0,0,6,288,2,274,0,2680,28,336
2696,1144,1144,1144,1144,16,1128,1142,1128,1128,1128,16,16,8,8,0,0,0,0,0,0,0,0,0,0,0,8,0,15,1119,0,2696,28,338
2712,1144,1146,1144,1144,48,1098,1099,1098,1098,1098,10,10,10,8,0,0,0,0,0,0,0,0,0,0,0,8,2,1,1088,0,2712,28,340
2728,1144,1144,1144,1144,16,1128,1136,1128,1128,1128,8,8,8,8,0,0,0,0,0,0,0,0,0,0,0,8,0,8,1120,0,2728,28,342
2744,1144,1151,1144,1144,64,1087,1088,1087,1087,1087,15,15,15,8,0,0,0,0,0,0,0,0,0,0,0,8,7,1,1072,0,2744,28,344
2760,1144,1144,1144,1144,16,1128,1136,1128,1128,1128,8,8,8,8,0,0,0,0,0,0,0,0,0,0,0,8,0,8,1120,0,2760,28,346
2776,1144,1144,1144,1144,16,1128,1142,1128,1128,1128,16,16,8,8,0,0,0,0,0,0,0,0,0,0,0,8,0,15,1119,0,2776,28,348
2792,1144,1171,1144,1144,144,1027,1029,1027,1027,1027,35,35,35,8,0,0,0,0,0,0,0,0,0,0,0,8,27,2,992,0,2792,28,350
2808,1144,1144,1144,1144,16,1128,1134,1128,1128,1128,16,16,8,8,0,0,0,0,0,0,0,0,0,0,0,8,0,11,1115,0,2808,28,352
2824,1144,1144,1144,1144,16,1128,1142,1128,1128,1128,16,16,8,8,0,0,0,0,0,0,0,0,0,0,0,8,0,15,1119,0,2824,28,354
2840,1144,1152,1144,1144,64,1088,1090,1088,1088,1088,16,16,16,8,0,0,0,0,0,0,0,0,0,0,0,8,8,2,1072,0,2840,28,356
2856,1144,1153,1144,1144,32,1121,1125,1121,1121,1121,25,25,17,8,0,0,0,0,0,0,0,0,0,0,0,8,9,10,1098,0,2856,28,358
2872,1144,1146,1144,1144,48,1098,1098,1098,1098,1098,10,10,10,8,0,0,0,0,0,0,0,0,0,0,0,8,2,0,1088,0,2872,28,360
2888,1144,1182,1144,1144,1144,38,38,38,38,38,38,38,38,0,0,0,0,0,0,0,0,0,0,0,0,0,38,0,0,0,2888,28,362
2904,1144,1146,1144,1144,48,1098,1099,1098,1098,1098,10,10,10,8,0,0,0,0,0,0,0,0,0,0,0,8,2,1,1088,0,2904,28,364
2920,1144,1149,1144,1144,1144,5,5,5,5,5,5,5,5,0,0,0,0,0,0,0,0,0,0,0,0,0,5,0,0,0,2920,28,366
2936,1144,1154,1144,1144,48,1106,1110,1106,1106,1106,18,18,18,8,0,0,0,0,0,0,0,0,0,0,0,8,10,4,1088,0,2936,28,368
2952,1144,1144,1144,1144,16,1128,1132,1128,1128,1128,16,16,8,8,0,0,0,0,0,0,0,0,0,0,0,8,0,10,1114,0,2952,28,370
2968,1144,1169,1144,1144,255,914,915,914,914,914,32,32,32,7,0,0,0,0,0,0,0,0,0,0,0,7,25,1,882,0,2968,28,372
2984,1144,1146,1144,1144,32,1114,1116,1114,1114,1114,18,18,10,8,0,0,0,0,0,0,0,0,0,0,0,8,2,9,1097,0,2984,28,374
3000,1144,1154,1144,1144,48,1106,1110,1106,1106,1106,18,18,18,8,0,0,0,0,0,0,0,0,0,0,0,8,10,4,1088,0,3000,28,376
3016,1144,1152,1144,1144,32,1120,1124,1120,1120,1120,24,24,16,8,0,0,0,0,0,0,0,0,0,0,0,8,8,10,1098,0,3016,28,378
3032,1144,1204,1144,1144,1144,60,60,60,60,60,60,60,60,0,0,0,0,0,0,0,0,0,0,0,0,0,60,0,0,0,3032,28,380
3048,1144,1217,1144,1144,437,780,780,780,780,780,80,80,80,7,0,0,0,0,0,0,0,0,0,0,0,7,73,0,700,0,3048,28,382
3064,1144,1148,1144,1144,24,1124,1138,1124,1124,1124,19,18,11,7,0,0,0,0,0,0,0,0,0,0,0,7,4,15,1112,0,3064,28,384
3080,1144,1144,1144,1144,16,1128,1134,1128,1128,1128,16,16,8,8,0,0,0,0,0,0,0,0,0,0,0,8,0,11,1115,0,3080,28,386
3096,1144,1148,1144,1144,47,1101,1102,1101,1101,1101,13,13,13,8,0,0,0,0,0,0,0,0,0,0,0,8,5,1,1088,0,3096,28,388
3112,1144,1148,1144,1144,46,1102,1103,1102,1102,1102,14,14,14,8,0,0,0,0,0,0,0,0,0,0,0,8,6,1,1088,0,3112,28,390
3128,1144,1145,1144,1144,24,1121,1123,1121,1121,1121,17,17,9,8,0,0,0,0,0,0,0,0,0,0,0,8,1,9,1105,0,3128,28,392
3144,1144,1144,1144,1144,16,1128,1142,1128,1128,1128,16,16,8,8,0,0,0,0,0,0,0,0,0,0,0,8,0,15,1119,0,3144,28,394
3160,1144,1164,1144,1144,1144,20,20,20,20,20,20,20,20,0,0,0,0,0,0,0,0,0,0,0,0,0,20,0,0,0,3160,28,396
3176,1144,1350,1144,1144,1144,206,206,206,206,206,206,206,206,0,0,0,0,0,0,0,0,0,0,0,0,0,206,0,0,0,3176,28,398
3192,1144,1144,1144,1144,16,1128,1136,1128,1128,1128,16,16,8,8,0,0,0,0,0,0,0,0,0,0,0,8,0,12,1116,0,3192,28,400
3208,1144,1144,1144,1144,16,1128,1130,1128,1128,1128,16,16,8,8,0,0,0,0,0,0,0,0,0,0,0,8,0,9,1113,0,3208,28,402
3224,1144,1164,1144,1144,1144,20,20,20,20,20,20,20,20,0,0,0,0,0,0,0,0,0,0,0,0,0,20,0,0,0,3224,28,404
3240,1144,1152,1144,1144,48,1104,1106,1104,1104,1104,24,24,16,8,0,0,0,0,0,0,0,0,0,0,0,8,8,9,1081,0,3240,28,406
3256,1144,1152,1144,1144,80,1072,1074,1072,1072,1072,24,24,16,8,0,0,0,0,0,0,0,0,0,0,0,8,8,9,1049,0,3256,28,408
3272,1144,1144,1144,1144,16,1128,1140,1128,1128,1128,16,16,8,8,0,0,0,0,0,0,0,0,0,0,0,8,0,14,1118,0,3272,28,410
3288,1144,1144,1144,1144,16,1128,1134,1128,1128,1128,16,16,8,8,0,0,0,0,0,0,0,0,0,0,0,8,0,11,1115,0,3288,28,412
3304,1144,1157,1144,1144,1144,13,13,13,13,13,13,13,13,0,0,0,0,0,0,0,0,0,0,0,0,0,13,0,0,0,3304,28,414
3320,1144,1246,1144,1144,562,684,685,684,684,684,108,108,108,6,0,0,0,0,0,0,0,0,0,0,0,6,102,1,576,0,3320,28,416
3336,1144,1147,1144,1144,48,1099,1100,1099,1099,1099,11,11,11,8,0,0,0,0,0,0,0,0,0,0,0,8,3,1,1088,0,3336,28,418
3352,1144,1150,1144,1144,63,1087,1088,1087,1087,1087,15,15,15,8,0,0,0,0,0,0,0,0,0,0,0,8,7,1,1072,0,3352,28,420
3368,1144,1148,1144,1144,1144,4,4,4,4,4,4,4,4,0,0,0,0,0,0,0,0,0,0,0,0,0,4,0,0,0,3368,28,422
3384,1144,1144,1144,1144,16,1128,1134,1128,1128,1128,8,8,8,8,0,0,0,0,0,0,0,0,0,0,0,8,0,6,1120,0,3384,28,424
3400,1144,1148,1144,1144,1144,4,4,4,4,4,4,4,4,0,0,0,0,0,0,0,0,0,0,0,0,0,4,0,0,0,3400,28,426
3416,1144,1144,1144,1144,16,1128,1130,1128,1128,1128,16,16,8,8,0,0,0,0,0,0,0,0,0,0,0,8,0,9,1113,0,3416,28,428
3432,1144,1144,1144,1144,16,1128,1136,1128,1128,1128,8,8,8,8,0,0,0,0,0,0,0,0,0,0,0,8,0,8,1120,0,3432,28,430
3448,1144,1144,1144,1144,16,1128,1138,1128,1128,1128,16,16,8,8,0,0,0,0,0,0,0,0,0,0,0,8,0,13,1117,0,3448,28,432
3464,1144,1144,1144,1144,16,1128,1140,1128,1128,1128,16,16,8,8,0,0,0,0,0,0,0,0,0,0,0,8,0,14,1118,0,3464,28,434
3480,1144,1151,1144,1144,48,1103,1105,1103,1103,1103,23,23,15,8,0,0,0,0,0,0,0,0,0,0,0,8,7,9,1081,0,3480,28,436
3496,1144,1146,1144,1144,24,1122,1126,1122,1122,1122,18,18,10,8,0,0,0,0,0,0,0,0,0,0,0,8,2,10,1106,0,3496,28,438
3512,1144,1161,1144,1144,1144,17,17,17,17,17,17,17,17,0,0,0,0,0,0,0,0,0,0,0,0,0,17,0,0,0,3512,28,440
3528,1144,1153,1144,1144,62,1091,1092,1091,1091,1091,19,19,19,8,0,0,0,0,0,0,0,0,0,0,0,8,11,1,1072,0,3528,28,442
3544,1144,1144,1144,1144,16,1128,1136,1128,1128,1128,16,16,8,8,0,0,0,0,0,0,0,0,0,0,0,8,0,12,1116,0,3544,28,444
3560,1144,1359,1144,1144,1144,215,215,215,215,215,215,215,215,0,0,0,0,0,0,0,0,0,0,0,0,0,215,0,0,0,3560,28,446
3576,1144,1244,1144,1144,192,1052,1058,1052,1052,1052,108,108,108,8,0,0,0,0,0,0,0,0,0,0,0,8,100,6,944,0,3576,28,448
3592,1144,1144,1144,1144,16,1128,1131,1128,1128,1128,8,8,8,8,0,0,0,0,0,0,0,0,0,0,0,8,0,3,1120,0,3592,28,450
3608,1144,1144,1144,1144,16,1128,1130,1128,1128,1128,8,8,8,8,0,0,0,0,0,0,0,0,0,0,0,8,0,2,1120,0,3608,28,452
3624,1144,1149,1144,1144,1144,5,5,5,5,5,5,5,5,0,0,0,0,0,0,0,0,0,0,0,0,0,5,0,0,0,3624,28,454
3640,1144,1144,1144,1144,16,1128,1133,1128,1128,1128,8,8,8,8,0,0,0,0,0,0,0,0,0,0,0,8,0,5,1120,0,3640,28,456
3656,1144,1144,1144,1144,16,1128,1140,1128,1128,1128,16,16,8,8,0,0,0,0,0,0,0,0,0,0,0,8,0,14,1118,0,3656,28,458
3672,1144,1155,1144,1144,48,1107,1110,1107,1107,1107,19,19,19,8,0,0,0,0,0,0,0,0,0,0,0,8,11,3,1088,0,3672,28,460
3688,1144,1144,1144,1144,16,1128,1140,1128,1128,1128,16,16,8,8,0,0,0,0,0,0,0,0,0,0,0,8,0,14,1118,0,3688,28,462
3704,1144,1236,1144,1144,997,239,239,239,239,239,95,95,95,3,0,0,0,0,0,0,0,0,0,0,0,3,92,0,144,0,3704,28,464
3720,1144,1144,1144,1144,16,1128,1136,1128,1128,1128,8,8,8,8,0,0,0,0,0,0,0,0,0,0,0,8,0,8,1120,0,3720,28,466
3736,1144,1150,1144,1144,47,1103,1104,1103,1103,1103,15,15,15,8,0,0,0,0,0,0,0,0,0,0,0,8,7,1,1088,0,3736,28,468
3752,1144,1144,1144,1144,16,1128,1132,1128,1128,1128,16,16,8,8,0,0,0,0,0,0,0,0,0,0,0,8,0,10,1114,0,3752,28,470
3768,1144,1152,1144,1144,1144,8,8,8,8,8,8,8,8,0,0,0,0,0,0,0,0,0,0,0,0,0,8,0,0,0,3768,28,472
3784,1144,1184,1144,1144,1144,40,40,40,40,40,40,40,40,0,0,0,0,0,0,0,0,0,0,0,0,0,40,0,0,0,3784,28,474
3800,1144,1152,1144,1144,47,1105,1107,1105,1105,1105,17,17,17,8,0,0,0,0,0,0,0,0,0,0,0,8,9,2,1088,0,3800,28,476
3816,1144,1162,1144,1144,1144,18,18,18,18,18,18,18,18,0,0,0,0,0,0,0,0,0,0,0,0,0,18,0,0,0,3816,28,478
3832,1144,1425,1144,1144,367,1058,1064,1058,1058,1058,288,288,288,7,0,0,0,0,0,0,0,0,0,0,0,7,281,6,770,0,3832,28,480
3848,1144,1150,1144,1144,46,1104,1106,1104,1104,1104,16,16,16,8,0,0,0,0,0,0,0,0,0,0,0,8,8,2,1088,0,3848,28,482
3864,1144,1157,1144,1144,48,1109,1113,1109,1109,1109,21,21,21,8,0,0,0,0,0,0,0,0,0,0,0,8,13,4,1088,0,3864,28,484
3880,1144,1171,1144,1144,1144,27,27,27,27,27,27,27,27,0,0,0,0,0,0,0,0,0,0,0,0,0,27,0,0,0,3880,28,486
3896,1144,1151,1144,1144,1144,7,7,7,7,7,7,7,7,0,0,0,0,0,0,0,0,0,0,0,0,0,7,0,0,0,3896,28,488
3912,1144,1211,1144,1144,538,673,673,673,673,673,73,73,73,6,0,0,0,0,0,0,0,0,0,0,0,6,67,0,600,0,3912,28,490
3928,1144,1144,1144,1144,16,1128,1136,1128,1128,1128,16,16,8,8,0,0,0,0,0,0,0,0,0,0,0,8,0,12,1116,0,3928,28,492
3944,1144,1144,1144,1144,16,1128,1140,1128,1128,1128,16,16,8,8,0,0,0,0,0,0,0,0,0,0,0,8,0,14,1118,0,3944,28,494
3960,1144,1144,1144,1144,16,1128,1133,1128,1128,1128,8,8,8,8,0,0,0,0,0,0,0,0,0,0,0,8,0,5,1120,0,3960,28,496
3976,1144,1144,1144,1144,16,1128,1132,1128,1128,1128,16,16,8,8,0,0,0,0,0,0,0,0,0,0,0,8,0,10,1114,0,3976,28,498
3992,1144,1160,1144,1144,1144,16,16,16,16,16,16,16,16,0,0,0,0,0,0,0,0,0,0,0,0,0,16,0,0,0,3992,28,500
4008,1144,1144,1144,1144,16,1128,1131,1128,1128,1128,8,7,7,7,0,0,0,0,0,0,0,0,0,0,0,7,0,4,1120,0,4008,28,502
4024,1144,1195,1144,1144,1144,51,51,51,51,51,51,51,51,0,0,0,0,0,0,0,0,0,0,0,0,0,51,0,0,0,4024,28,504
4040,1144,1156,1144,1144,112,1044,1044,1044,1044,1044,20,20,20,8,0,0,0,0,0,0,0,0,0,0,0,8,12,0,1024,0,4040,28,506
4056,1144,1144,1144,1144,16,1128,1136,1128,1128,1128,8,8,8,8,0,0,0,0,0,0,0,0,0,0,0,8,0,8,1120,0,4056,28,508
4072,1144,1153,1144,1144,62,1091,1092,1091,1091,1091,19,19,19,8,0,0,0,0,0,0,0,0,0,0,0,8,11,1,1072,0,4072,28,510
4088,1144,1144,1144,1144,16,1128,1128,1128,1128,1128,8,0,0,0,0,0,0,0,0,0,0,0,0,0,0,0,0,8,1120,0,4088,28,512
4104,1144,1147,1144,1144,32,1115,1117,1115,1115,1115,11,11,11,8,0,0,0,0,0,0,0,0,0,0,0,8,3,2,1104,0,4104,28,514
4120,1144,1144,1144,1144,16,1128,1136,1128,1128,1128,8,8,8,8,0,0,0,0,0,0,0,0,0,0,0,8,0,8,1120,0,4120,28,516
4136,1144,1156,1144,1144,48,1108,1120,1108,1108,1108,28,28,20,8,0,0,0,0,0,0,0,0,0,0,0,8,12,14,1086,0,4136,28,518
4152,1144,1145,1144,1144,32,1113,1114,1113,1113,1113,9,9,9,8,0,0,0,0,0,0,0,0,0,0,0,8,1,1,1104,0,4152,28,520
4168,1144,1156,1144,1144,48,1108,1115,1108,1108,1108,20,20,20,8,0,0,0,0,0,0,0,0,0,0,0,8,12,7,1088,0,4168,28,522
4184,1144,1156,1144,1144,1144,12,12,12,12,12,12,12,12,0,0,0,0,0,0,0,0,0,0,0,0,0,12,0,0,0,4184,28,524
4200,1144,1175,1144,1144,1144,31,31,31,31,31,31,31,31,0,0,0,0,0,0,0,0,0,0,0,0,0,31,0,0,0,4200,28,526
4216,1144,1144,1144,1144,16,1128,1136,1128,1128,1128,8,8,8,8,0,0,0,0,0,0,0,0,0,0,0,8,0,8,1120,0,4216,28,528
4232,1144,1144,1144,1144,16,1128,1135,1128,1128,1128,8,7,7,7,0,0,0,0,0,0,0,0,0,0,0,7,0,8,1120,0,4232,28,530
4248,1144,1250,1144,1144,1144,106,106,106,106,106,106,106,106,0,0,0,0,0,0,0,0,0,0,0,0,0,106,0,0,0,4248,28,532
4264,1144,1178,1144,1144,128,1050,1053,1050,1050,1050,42,42,42,8,0,0,0,0,0,0,0,0,0,0,0,8,34,3,1008,0,4264,28,534
4280,1144,1147,1144,1144,32,1115,1121,1115,1115,1115,19,19,11,8,0,0,0,0,0,0,0,0,0,0,0,8,3,11,1099,0,4280,28,536
4296,1144,1155,1144,1144,40,1115,1120,1115,1115,1115,19,19,19,8,0,0,0,0,0,0,0,0,0,0,0,8,11,5,1096,0,4296,28,538
4312,1144,1156,1144,1144,1144,12,12,12,12,12,12,12,12,0,0,0,0,0,0,0,0,0,0,0,0,0,12,0,0,0,4312,28,540
4328,1144,1191,1144,1144,176,1015,1019,1015,1015,1015,55,55,55,8,0,0,0,0,0,0,0,0,0,0,0,8,47,4,960,0,4328,28,542
4344,1144,1156,1144,1144,136,1020,1020,1020,1020,1020,20,20,20,8,0,0,0,0,0,0,0,0,0,0,0,8,12,0,1000,0,4344,28,544
4360,1144,1149,1144,1144,48,1101,1103,1101,1101,1101,13,13,13,8,0,0,0,0,0,0,0,0,0,0,0,8,5,2,1088,0,4360,28,546
4376,1144,1173,1144,1144,1144,29,29,29,29,29,29,29,29,0,0,0,0,0,0,0,0,0,0,0,0,0,29,0,0,0,4376,28,548
4392,1144,1223,1144,1144,255,968,972,968,968,968,86,86,86,7,0,0,0,0,0,0,0,0,0,0,0,7,79,4,882,0,4392,28,550
4408,1144,1164,1144,1144,144,1020,1020,1020,1020,1020,28,28,28,8,0,0,0,0,0,0,0,0,0,0,0,8,20,0,992,0,4408,28,552
4424,1144,1177,1144,1144,240,937,938,937,937,937,41,41,41,8,0,0,0,0,0,0,0,0,0,0,0,8,33,1,896,0,4424,28,554
4440,1144,1149,1144,1144,32,1117,1123,1117,1117,1117,21,21,13,8,0,0,0,0,0,0,0,0,0,0,0,8,5,11,1099,0,4440,28,556
4456,1144,1227,1144,1144,478,749,749,749,749,749,89,89,89,6,0,0,0,0,0,0,0,0,0,0,0,6,83,0,660,0,4456,28,558
4472,1144,1259,1144,1144,1086,173,173,173,173,173,117,117,117,2,0,0,0,0,0,0,0,0,0,0,0,2,115,0,56,0,4472,28,560
4488,1144,1156,1144,1144,1144,12,12,12,12,12,12,12,12,0,0,0,0,0,0,0,0,0,0,0,0,0,12,0,0,0,4488,28,562
4504,1144,1165,1144,1144,96,1069,1070,1069,1069,1069,29,29,29,8,0,0,0,0,0,0,0,0,0,0,0,8,21,1,1040,0,4504,28,564
4520,1144,1152,1144,1144,1144,8,8,8,8,8,8,8,8,0,0,0,0,0,0,0,0,0,0,0,0,0,8,0,0,0,4520,28,566
4536,1144,1182,1144,1144,339,843,843,843,843,843,45,45,45,7,0,0,0,0,0,0,0,0,0,0,0,7,38,0,798,0,4536,28,568
4552,1144,1167,1144,1144,80,1087,1091,1087,1087,1087,31,31,31,8,0,0,0,0,0,0,0,0,0,0,0,8,23,4,1056,0,4552,28,570
4568,1144,1144,1144,1144,16,1128,1136,1128,1128,1128,8,8,8,8,0,0,0,0,0,0,0,0,0,0,0,8,0,8,1120,0,4568,28,572
4584,1144,1171,1144,1144,1144,27,27,27,27,27,27,27,27,0,0,0,0,0,0,0,0,0,0,0,0,0,27,0,0,0,4584,28,574
4600,1144,1266,1144,1144,409,857,861,857,857,857,129,129,129,7,0,0,0,0,0,0,0,0,0,0,0,7,122,4,728,0,4600,28,576
4616,1144,1277,1144,1144,1144,133,133,133,133,133,133,133,133,0,0,0,0,0,0,0,0,0,0,0,0,0,133,0,0,0,4616,28,578
4632,1144,1144,1144,1144,16,1128,1131,1128,1128,1128,8,8,8,8,0,0,0,0,0,0,0,0,0,0,0,8,0,3,1120,0,4632,28,580
4648,1144,1165,1144,1144,1144,21,21,21,21,21,21,21,21,0,0,0,0,0,0,0,0,0,0,0,0,0,21,0,0,0,4648,28,582
4664,1144,1144,1144,1144,16,1128,1133,1128,1128,1128,8,8,8,8,0,0,0,0,0,0,0,0,0,0,0,8,0,5,1120,0,4664,28,584
4680,1144,1151,1144,1144,1144,7,7,7,7,7,7,7,7,0,0,0,0,0,0,0,0,0,0,0,0,0,7,0,0,0,4680,28,586
4696,1144,1161,1144,1144,1144,17,17,17,17,17,17,17,17,0,0,0,0,0,0,0,0,0,0,0,0,0,17,0,0,0,4696,28,588
4712,1144,1187,1144,1144,208,979,981,979,979,979,51,51,51,8,0,0,0,0,0,0,0,0,0,0,0,8,43,2,928,0,4712,28,590
4728,1144,1282,1144,1144,1110,172,172,172,172,172,140,140,140,2,0,0,0,0,0,0,0,0,0,0,0,2,138,0,32,0,4728,28,592
4744,1144,1153,1144,1144,1144,9,9,9,9,9,9,9,9,0,0,0,0,0,0,0,0,0,0,0,0,0,9,0,0,0,4744,28,594
4760,1144,1150,1144,1144,48,1102,1102,1102,1102,1102,14,14,14,8,0,0,0,0,0,0,0,0,0,0,0,8,6,0,1088,0,4760,28,596
4776,1144,1146,1144,1144,1144,2,2,2,2,2,2,2,2,0,0,0,0,0,0,0,0,0,0,0,0,0,2,0,0,0,4776,28,598
4792,1144,1146,1144,1144,32,1114,1114,1114,1114,1114,18,18,10,8,0,0,0,0,0,0,0,0,0,0,0,8,2,8,1096,0,4792,28,600
4808,1144,1148,1144,1144,32,1116,1118,1116,1116,1116,12,12,12,8,0,0,0,0,0,0,0,0,0,0,0,8,4,2,1104,0,4808,28,602
4824,1144,1181,1144,1144,255,926,926,926,926,926,44,44,44,7,0,0,0,0,0,0,0,0,0,0,0,7,37,0,882,0,4824,28,604
4840,1144,1178,1144,1144,80,1098,1103,1098,1098,1098,42,42,42,8,0,0,0,0,0,0,0,0,0,0,0,8,34,5,1056,0,4840,28,606
4856,1144,1274,1144,1144,759,515,517,515,515,515,135,135,135,5,0,0,0,0,0,0,0,0,0,0,0,5,130,2,380,0,4856,28,608
4872,1144,1180,1144,1144,1144,36,36,36,36,36,36,36,36,0,0,0,0,0,0,0,0,0,0,0,0,0,36,0,0,0,4872,28,610
4888,1144,1144,1144,1144,48,1096,1098,1096,1096,1096,16,16,8,8,0,0,0,0,0,0,0,0,0,0,0,8,0,9,1081,0,4888,28,612
4904,1144,1157,1144,1144,1144,13,13,13,13,13,13,13,13,0,0,0,0,0,0,0,0,0,0,0,0,0,13,0,0,0,4904,28,614
4920,1144,1166,1144,1144,80,1086,1091,1086,1086,1086,30,30,30,8,0,0,0,0,0,0,0,0,0,0,0,8,22,5,1056,0,4920,28,616
4936,1144,1164,1144,1144,1144,20,20,20,20,20,20,20,20,0,0,0,0,0,0,0,0,0,0,0,0,0,20,0,0,0,4936,28,618
4952,1144,1196,1144,1144,283,913,915,913,913,913,59,59,59,7,0,0,0,0,0,0,0,0,0,0,0,7,52,2,854,0,4952,28,620
4968,1144,1144,1144,1144,16,1128,1136,1128,1128,1128,8,8,8,8,0,0,0,0,0,0,0,0,0,0,0,8,0,8,1120,0,4968,28,622
4984,1144,1144,1144,1144,48,1096,1096,1096,1096,1096,16,16,8,8,0,0,0,0,0,0,0,0,0,0,0,8,0,8,1080,0,4984,28,624
5000,1144,1183,1144,1144,160,1023,1025,1023,1023,1023,47,47,47,8,0,0,0,0,0,0,0,0,0,0,0,8,39,2,976,0,5000,28,626
5016,1144,1144,1144,1144,16,1128,1131,1128,1128,1128,8,8,8,8,0,0,0,0,0,0,0,0,0,0,0,8,0,3,1120,0,5016,28,628
5032,1144,1144,1144,1144,48,1096,1100,1096,1096,1096,16,16,8,8,0,0,0,0,0,0,0,0,0,0,0,8,0,10,1082,0,5032,28,630
5048,1144,1146,1144,1144,32,1114,1116,1114,1114,1114,18,18,10,8,0,0,0,0,0,0,0,0,0,0,0,8,2,9,1097,0,5048,28,632
5064,1144,1149,1144,1144,1144,5,5,5,5,5,5,5,5,0,0,0,0,0,0,0,0,0,0,0,0,0,5,0,0,0,5064,28,634
5080,1144,1152,1144,1144,1144,8,8,8,8,8,8,8,8,0,0,0,0,0,0,0,0,0,0,0,0,0,8,0,0,0,5080,28,636
5096,1144,1230,1144,1144,311,919,921,919,919,919,93,93,93,7,0,0,0,0,0,0,0,0,0,0,0,7,86,2,826,0,5096,28,638
5112,1144,1304,1144,1144,240,1064,1071,1064,1064,1064,168,168,168,8,0,0,0,0,0,0,0,0,0,0,0,8,160,7,896,0,5112,28,640
5128,1144,1202,1144,1144,1144,58,58,58,58,58,58,58,58,0,0,0,0,0,0,0,0,0,0,0,0,0,58,0,0,0,5128,28,642
5144,1144,1144,1144,1144,16,1128,1132,1128,1128,1128,8,8,8,8,0,0,0,0,0,0,0,0,0,0,0,8,0,4,1120,0,5144,28,644
5160,1144,1144,1144,1144,16,1128,1134,1128,1128,1128,8,8,8,8,0,0,0,0,0,0,0,0,0,0,0,8,0,6,1120,0,5160,28,646
5176,1144,1144,1144,1144,16,1128,1131,1128,1128,1128,8,8,8,8,0,0,0,0,0,0,0,0,0,0,0,8,0,3,1120,0,5176,28,648
5192,1144,1144,1144,1144,16,1128,1142,1128,1128,1128,16,16,8,8,0,0,0,0,0,0,0,0,0,0,0,8,0,15,1119,0,5192,28,650
5208,1144,1190,1144,1144,269,921,922,921,921,921,53,53,53,7,0,0,0,0,0,0,0,0,0,0,0,7,46,1,868,0,5208,28,652
5224,1144,1145,1144,1144,1144,1,1,1,1,1,1,1,1,0,0,0,0,0,0,0,0,0,0,0,0,0,1,0,0,0,5224,28,654
5240,1144,1329,1144,1144,1135,194,194,194,194,194,186,186,186,1,0,0,0,0,0,0,0,0,0,0,0,1,185,0,8,0,5240,28,656
5256,1144,1144,1144,1144,16,1128,1134,1128,1128,1128,16,16,8,8,0,0,0,0,0,0,0,0,0,0,0,8,0,11,1115,0,5256,28,658
5272,1144,1173,1144,1144,144,1029,1032,1029,1029,1029,37,37,37,8,0,0,0,0,0,0,0,0,0,0,0,8,29,3,992,0,5272,28,660
5288,1144,1144,1144,1144,16,1128,1142,1128,1128,1128,16,16,8,8,0,0,0,0,0,0,0,0,0,0,0,8,0,15,1119,0,5288,28,662
5304,1144,1162,1144,1144,1144,18,18,18,18,18,18,18,18,0,0,0,0,0,0,0,0,0,0,0,0,0,18,0,0,0,5304,28,664
5320,1144,1144,1144,1144,16,1128,1136,1128,1128,1128,8,8,8,8,0,0,0,0,0,0,0,0,0,0,0,8,0,8,1120,0,5320,28,666
5336,1144,1155,1144,1144,1144,11,11,11,11,11,11,11,11,0,0,0,0,0,0,0,0,0,0,0,0,0,11,0,0,0,5336,28,668
5352,1144,1145,1144,1144,1144,1,1,1,1,1,1,1,1,0,0,0,0,0,0,0,0,0,0,0,0,0,1,0,0,0,5352,28,670
5368,1144,1396,1144,1144,819,577,579,577,577,577,257,257,257,5,0,0,0,0,0,0,0,0,0,0,0,5,252,2,320,0,5368,28,672
5384,1144,1191,1144,1144,128,1063,1075,1063,1063,1063,63,63,55,8,0,0,0,0,0,0,0,0,0,0,0,8,47,14,1006,0,5384,28,674
5400,1144,1144,1144,1144,16,1128,1142,1128,1128,1128,16,16,8,8,0,0,0,0,0,0,0,0,0,0,0,8,0,15,1119,0,5400,28,676
5416,1144,1144,1144,1144,16,1128,1136,1128,1128,1128,8,8,8,8,0,0,0,0,0,0,0,0,0,0,0,8,0,8,1120,0,5416,28,678
5432,1144,1146,1144,1144,48,1098,1099,1098,1098,1098,10,10,10,8,0,0,0,0,0,0,0,0,0,0,0,8,2,1,1088,0,5432,28,680
5448,1144,1144,1144,1144,16,1128,1142,1128,1128,1128,16,16,8,8,0,0,0,0,0,0,0,0,0,0,0,8,0,15,1119,0,5448,28,682
5464,1144,1144,1144,1144,16,1128,1136,1128,1128,1128,8,8,8,8,0,0,0,0,0,0,0,0,0,0,0,8,0,8,1120,0,5464,28,684


124,31,31,31,31,2,29,29,29,29,29,1,0,0,0,0,0,0,0,0,0,0,0,0,0,0,0,0,1,28,0,992,28,32
132,64,72,64,64,62,10,10,10,10,10,10,10,10,2,0,0,0,0,0,0,0,0,0,0,0,2,8,0,0,0,1056,56,34
140,66,68,66,66,66,2,2,2,2,2,2,2,2,0,0,0,0,0,0,0,0,0,0,0,0,0,2,0,0,0,1120,56,36
148,68,68,68,68,67,1,1,1,1,1,1,1,1,1,0,0,0,0,0,0,0,0,0,0,0,1,0,0,0,0,1184,56,38
156,70,78,70,70,70,8,8,8,8,8,8,8,8,0,0,0,0,0,0,0,0,0,0,0,0,0,8,0,0,0,1248,56,40
164,72,72,72,72,72,0,0,0,0,0,0,0,0,0,0,0,0,0,0,0,0,0,0,0,0,0,0,0,0,0,1312,56,42
172,74,74,74,74,4,70,74,70,70,70,5,5,2,2,0,0,0,0,0,0,0,0,0,0,0,2,0,5,67,0,1376,56,44
180,76,78,76,76,17,61,62,61,61,61,4,4,4,2,0,0,0,0,0,0,0,0,0,0,0,2,2,1,57,0,1440,56,46
188,78,80,78,78,6,74,78,74,74,74,6,6,4,2,0,0,0,0,0,0,0,0,0,0,0,2,2,4,70,0,1504,56,48
196,80,80,80,80,5,75,77,75,75,75,4,4,2,2,0,0,0,0,0,0,0,0,0,0,0,2,0,3,72,0,1568,56,50
204,82,88,82,82,82,6,6,6,6,6,6,6,6,0,0,0,0,0,0,0,0,0,0,0,0,0,6,0,0,0,1632,56,52
212,84,84,84,84,4,80,84,80,80,80,4,4,2,2,0,0,0,0,0,0,0,0,0,0,0,2,0,4,78,0,1696,56,54
220,86,143,86,86,68,75,78,75,75,75,62,62,62,5,0,0,0,0,0,0,0,0,0,0,0,5,57,3,13,0,1760,56,56
228,88,94,88,88,88,6,6,6,6,6,6,6,6,0,0,0,0,0,0,0,0,0,0,0,0,0,6,0,0,0,1824,56,58
236,90,140,90,90,89,51,51,51,51,51,51,51,51,1,0,0,0,0,0,0,0,0,0,0,0,1,50,0,0,0,1888,56,60
244,92,92,92,92,4,88,89,88,88,88,2,2,2,2,0,0,0,0,0,0,0,0,0,0,0,2,0,1,86,0,1952,56,62
252,94,94,94,94,4,90,90,90,90,90,2,0,0,0,0,0,0,0,0,0,0,0,0,0,0,0,0,2,88,0,2016,56,64
260,159,159,159,159,7,152,155,152,152,152,3,3,3,3,0,0,0,0,0,0,0,0,0,0,0,3,0,3,149,0,2080,84,66
268,161,169,161,161,69,100,100,100,100,100,11,11,11,3,0,0,0,0,0,0,0,0,0,0,0,3,8,0,89,0,2144,84,68
276,163,169,163,163,163,6,6,6,6,6,6,6,6,0,0,0,0,0,0,0,0,0,0,0,0,0,6,0,0,0,2208,84,70
284,165,187,165,165,165,22,22,22,22,22,22,22,22,0,0,0,0,0,0,0,0,0,0,0,0,0,22,0,0,0,2272,84,72
292,167,194,167,167,165,29,29,29,29,29,29,29,29,2,0,0,0,0,0,0,0,0,0,0,0,2,27,0,0,0,2336,84,74
300,169,169,169,169,169,0,0,0,0,0,0,0,0,0,0,0,0,0,0,0,0,0,0,0,0,0,0,0,0,0,2400,84,76
308,171,171,171,171,23,148,148,148,148,148,6,6,3,3,0,0,0,0,0,0,0,0,0,0,0,3,0,3,142,0,2464,84,78
316,173,249,173,173,117,132,135,132,132,132,82,82,82,6,0,0,0,0,0,0,0,0,0,0,0,6,76,3,50,0,2528,84,80
324,175,202,175,175,175,27,27,27,27,27,27,27,27,0,0,0,0,0,0,0,0,0,0,0,0,0,27,0,0,0,2592,84,82
332,177,178,177,177,177,1,1,1,1,1,1,1,1,0,0,0,0,0,0,0,0,0,0,0,0,0,1,0,0,0,2656,84,84
340,179,182,179,179,29,153,154,153,153,153,6,6,6,3,0,0,0,0,0,0,0,0,0,0,0,3,3,1,147,0,2720,84,86
348,181,181,181,181,6,175,181,175,175,175,6,6,3,3,0,0,0,0,0,0,0,0,0,0,0,3,0,6,172,0,2784,84,88
356,183,185,183,183,19,166,166,166,166,166,5,5,5,3,0,0,0,0,0,0,0,0,0,0,0,3,2,0,161,0,2848,84,90
364,185,191,185,185,21,170,172,170,170,170,9,9,9,3,0,0,0,0,0,0,0,0,0,0,0,3,6,2,161,0,2912,84,92
372,187,190,187,187,23,167,168,167,167,167,6,6,6,3,0,0,0,0,0,0,0,0,0,0,0,3,3,1,161,0,2976,84,94
380,189,191,189,189,9,182,188,182,182,182,8,8,5,3,0,0,0,0,0,0,0,0,0,0,0,3,2,6,177,0,3040,84,96
388,286,287,286,286,13,274,276,274,274,274,9,9,5,4,0,0,0,0,0,0,0,0,0,0,0,4,1,5,266,0,3104,112,98
396,288,288,288,288,8,280,284,280,280,280,9,9,4,4,0,0,0,0,0,0,0,0,0,0,0,4,0,7,273,0,3168,112,100
404,290,293,290,290,45,248,248,248,248,248,11,11,7,4,0,0,0,0,0,0,0,0,0,0,0,4,3,4,237,0,3232,112,102
412,292,324,292,292,292,32,32,32,32,32,32,32,32,0,0,0,0,0,0,0,0,0,0,0,0,0,32,0,0,0,3296,112,104
420,294,294,294,294,9,285,286,285,285,285,4,4,4,4,0,0,0,0,0,0,0,0,0,0,0,4,0,1,281,0,3360,112,106
428,296,296,296,296,8,288,294,288,288,288,11,11,4,4,0,0,0,0,0,0,0,0,0,0,0,4,0,10,280,0,3424,112,108
436,298,315,298,298,298,17,17,17,17,17,17,17,17,0,0,0,0,0,0,0,0,0,0,0,0,0,17,0,0,0,3488,112,110
444,300,384,300,300,123,261,266,261,261,261,91,91,91,7,0,0,0,0,0,0,0,0,0,0,0,7,84,5,170,0,3552,112,112
452,302,302,302,302,9,293,294,293,293,293,4,4,4,4,0,0,0,0,0,0,0,0,0,0,0,4,0,1,289,0,3616,112,114
460,304,310,304,304,304,6,6,6,6,6,6,6,6,0,0,0,0,0,0,0,0,0,0,0,0,0,6,0,0,0,3680,112,116
468,306,308,306,306,306,2,2,2,2,2,2,2,2,0,0,0,0,0,0,0,0,0,0,0,0,0,2,0,0,0,3744,112,118
476,308,473,308,308,242,231,234,231,231,231,171,171,171,6,0,0,0,0,0,0,0,0,0,0,0,6,165,3,60,0,3808,112,120
484,310,314,310,310,310,4,4,4,4,4,4,4,4,0,0,0,0,0,0,0,0,0,0,0,0,0,4,0,0,0,3872,112,122
492,312,312,312,312,8,304,306,304,304,304,4,4,4,4,0,0,0,0,0,0,0,0,0,0,0,4,0,2,300,0,3936,112,124
500,314,349,314,314,314,35,35,35,35,35,35,35,35,0,0,0,0,0,0,0,0,0,0,0,0,0,35,0,0,0,4000,112,126
508,316,316,316,316,8,308,308,308,308,308,4,0,0,0,0,0,0,0,0,0,0,0,0,0,0,0,0,4,304,0,4064,112,128
516,316,317,316,316,16,301,302,301,301,301,5,5,5,4,0,0,0,0,0,0,0,0,0,0,0,4,1,1,296,0,4128,112,130
524,316,316,316,316,8,308,312,308,308,308,4,4,4,4,0,0,0,0,0,0,0,0,0,0,0,4,0,4,304,0,4192,112,132
532,316,319,316,316,16,303,309,303,303,303,11,11,7,4,0,0,0,0,0,0,0,0,0,0,0,4,3,7,295,0,4256,112,134
540,316,326,316,316,75,251,251,251,251,251,14,14,14,4,0,0,0,0,0,0,0,0,0,0,0,4,10,0,237,0,4320,112,136
548,316,334,316,316,79,255,255,255,255,255,22,22,22,4,0,0,0,0,0,0,0,0,0,0,0,4,18,0,233,0,4384,112,138
556,316,323,316,316,316,7,7,7,7,7,7,7,7,0,0,0,0,0,0,0,0,0,0,0,0,0,7,0,0,0,4448,112,140
564,316,353,316,316,186,167,167,167,167,167,44,44,40,3,0,0,0,0,0,0,0,0,0,0,0,3,37,4,123,0,4512,112,142
572,316,390,316,316,223,167,169,167,167,167,78,78,78,4,0,0,0,0,0,0,0,0,0,0,0,4,74,2,89,0,4576,112,144
580,316,316,316,316,8,308,310,308,308,308,4,4,4,4,0,0,0,0,0,0,0,0,0,0,0,4,0,2,304,0,4640,112,146
588,316,344,316,316,316,28,28,28,28,28,28,28,28,0,0,0,0,0,0,0,0,0,0,0,0,0,28,0,0,0,4704,112,148
596,316,318,316,316,16,302,302,302,302,302,10,10,6,4,0,0,0,0,0,0,0,0,0,0,0,4,2,4,292,0,4768,112,150
604,316,354,316,316,316,38,38,38,38,38,38,38,38,0,0,0,0,0,0,0,0,0,0,0,0,0,38,0,0,0,4832,112,152
612,316,328,316,316,40,288,290,288,288,288,16,16,16,4,0,0,0,0,0,0,0,0,0,0,0,4,12,2,272,0,4896,112,154
620,316,316,316,316,24,292,292,292,292,292,8,8,4,4,0,0,0,0,0,0,0,0,0,0,0,4,0,4,284,0,4960,112,156
628,316,318,316,316,16,302,304,302,302,302,10,10,6,4,0,0,0,0,0,0,0,0,0,0,0,4,2,5,293,0,5024,112,158
636,316,404,316,316,120,284,287,284,284,284,92,92,92,4,0,0,0,0,0,0,0,0,0,0,0,4,88,3,192,0,5088,112,160
644,316,316,316,316,8,308,311,308,308,308,4,4,4,4,0,0,0,0,0,0,0,0,0,0,0,4,0,3,304,0,5152,112,162
652,316,369,316,316,316,53,53,53,53,53,53,53,53,0,0,0,0,0,0,0,0,0,0,0,0,0,53,0,0,0,5216,112,164
660,316,328,316,316,316,12,12,12,12,12,12,12,12,0,0,0,0,0,0,0,0,0,0,0,0,0,12,0,0,0,5280,112,166
668,316,361,316,316,316,45,45,45,45,45,45,45,45,0,0,0,0,0,0,0,0,0,0,0,0,0,45,0,0,0,5344,112,168
676,316,318,316,316,24,294,295,294,294,294,6,6,6,4,0,0,0,0,0,0,0,0,0,0,0,4,2,1,288,0,5408,112,170
684,316,319,316,316,32,287,288,287,287,287,7,7,7,4,0,0,0,0,0,0,0,0,0,0,0,4,3,1,280,0,5472,112,172
692,316,316,316,316,8,308,316,308,308,308,8,8,4,4,0,0,0,0,0,0,0,0,0,0,0,4,0,8,304,0,5536,112,174
700,316,316,316,316,8,308,314,308,308,308,8,8,4,4,0,0,0,0,0,0,0,0,0,0,0,4,0,7,303,0,5600,112,176
708,316,324,316,316,32,292,294,292,292,292,12,12,12,4,0,0,0,0,0,0,0,0,0,0,0,4,8,2,280,0,5664,112,178
716,316,318,316,316,24,294,294,294,294,294,6,6,6,4,0,0,0,0,0,0,0,0,0,0,0,4,2,0,288,0,5728,112,180
724,316,318,316,316,24,294,295,294,294,294,6,6,6,4,0,0,0,0,0,0,0,0,0,0,0,4,2,1,288,0,5792,112,182
732,316,324,316,316,24,300,303,300,300,300,12,12,12,4,0,0,0,0,0,0,0,0,0,0,0,4,8,3,288,0,5856,112,184
740,316,341,316,316,127,214,215,214,214,214,28,28,28,3,0,0,0,0,0,0,0,0,0,0,0,3,25,1,186,0,5920,112,186
748,316,321,316,316,24,297,299,297,297,297,9,9,9,4,0,0,0,0,0,0,0,0,0,0,0,4,5,2,288,0,5984,112,188
756,316,357,316,316,316,41,41,41,41,41,41,41,41,0,0,0,0,0,0,0,0,0,0,0,0,0,41,0,0,0,6048,112,190
764,316,318,316,316,12,306,314,306,306,306,10,10,6,4,0,0,0,0,0,0,0,0,0,0,0,4,2,8,300,0,6112,112,192
772,316,320,316,316,23,297,298,297,297,297,9,9,9,4,0,0,0,0,0,0,0,0,0,0,0,4,5,1,288,0,6176,112,194
780,316,317,316,316,12,305,307,305,305,305,9,9,5,4,0,0,0,0,0,0,0,0,0,0,0,4,1,5,297,0,6240,112,196
788,316,321,316,316,316,5,5,5,5,5,5,5,5,0,0,0,0,0,0,0,0,0,0,0,0,0,5,0,0,0,6304,112,198
796,316,316,316,316,8,308,312,308,308,308,8,8,4,4,0,0,0,0,0,0,0,0,0,0,0,4,0,6,302,0,6368,112,200
804,316,335,316,316,316,19,19,19,19,19,19,19,19,0,0,0,0,0,0,0,0,0,0,0,0,0,19,0,0,0,6432,112,202
812,316,320,316,316,40,280,280,280,280,280,12,12,8,4,0,0,0,0,0,0,0,0,0,0,0,4,4,4,268,0,6496,112,204
820,316,316,316,316,8,308,310,308,308,308,8,8,4,4,0,0,0,0,0,0,0,0,0,0,0,4,0,5,301,0,6560,112,206
828,316,362,316,316,250,112,112,112,112,112,48,48,48,2,0,0,0,0,0,0,0,0,0,0,0,2,46,0,64,0,6624,112,208
836,316,322,316,316,31,291,292,291,291,291,11,11,11,4,0,0,0,0,0,0,0,0,0,0,0,4,7,1,280,0,6688,112,210
844,316,316,316,316,8,308,310,308,308,308,4,4,4,4,0,0,0,0,0,0,0,0,0,0,0,4,0,2,304,0,6752,112,212
852,316,316,316,316,8,308,310,308,308,308,8,8,4,4,0,0,0,0,0,0,0,0,0,0,0,4,0,5,301,0,6816,112,214
860,316,316,316,316,8,308,314,308,308,308,8,8,4,4,0,0,0,0,0,0,0,0,0,0,0,4,0,7,303,0,6880,112,216
868,316,322,316,316,24,298,300,298,298,298,14,14,10,4,0,0,0,0,0,0,0,0,0,0,0,4,6,5,285,0,6944,112,218
876,316,333,316,316,316,17,17,17,17,17,17,17,17,0,0,0,0,0,0,0,0,0,0,0,0,0,17,0,0,0,7008,112,220
884,316,316,316,316,8,308,316,308,308,308,8,8,4,4,0,0,0,0,0,0,0,0,0,0,0,4,0,8,304,0,7072,112,222
892,316,386,316,316,96,290,293,290,290,290,74,74,74,4,0,0,0,0,0,0,0,0,0,0,0,4,70,3,216,0,7136,112,224
900,316,316,316,316,8,308,310,308,308,308,4,4,4,4,0,0,0,0,0,0,0,0,0,0,0,4,0,2,304,0,7200,112,226
908,316,316,316,316,8,308,309,308,308,308,4,4,4,4,0,0,0,0,0,0,0,0,0,0,0,4,0,1,304,0,7264,112,228
916,316,326,316,316,24,302,304,302,302,302,14,14,14,4,0,0,0,0,0,0,0,0,0,0,0,4,10,2,288,0,7328,112,230
924,316,322,316,316,316,6,6,6,6,6,6,6,6,0,0,0,0,0,0,0,0,0,0,0,0,0,6,0,0,0,7392,112,232
932,316,320,316,316,23,297,298,297,297,297,9,9,9,4,0,0,0,0,0,0,0,0,0,0,0,4,5,1,288,0,7456,112,234
940,316,318,316,316,316,2,2,2,2,2,2,2,2,0,0,0,0,0,0,0,0,0,0,0,0,0,2,0,0,0,7520,112,236
948,316,320,316,316,23,297,298,297,297,297,9,9,9,4,0,0,0,0,0,0,0,0,0,0,0,4,5,1,288,0,7584,112,238
956,316,450,316,316,175,275,277,275,275,275,137,137,137,3,0,0,0,0,0,0,0,0,0,0,0,3,134,2,138,0,7648,112,240
964,316,325,316,316,24,301,304,301,301,301,13,13,13,4,0,0,0,0,0,0,0,0,0,0,0,4,9,3,288,0,7712,112,242
972,316,320,316,316,316,4,4,4,4,4,4,4,4,0,0,0,0,0,0,0,0,0,0,0,0,0,4,0,0,0,7776,112,244
980,316,316,316,316,8,308,312,308,308,308,8,8,4,4,0,0,0,0,0,0,0,0,0,0,0,4,0,6,302,0,7840,112,246
988,316,316,316,316,8,308,310,308,308,308,4,4,4,4,0,0,0,0,0,0,0,0,0,0,0,4,0,2,304,0,7904,112,248
996,316,332,316,316,316,16,16,16,16,16,16,16,16,0,0,0,0,0,0,0,0,0,0,0,0,0,16,0,0,0,7968,112,250
1004,316,351,316,316,316,35,35,35,35,35,35,35,35,0,0,0,0,0,0,0,0,0,0,0,0,0,35,0,0,0,8032,112,252
1012,316,316,316,316,8,308,312,308,308,308,4,4,4,4,0,0,0,0,0,0,0,0,0,0,0,4,0,4,304,0,8096,112,254
1020,316,316,316,316,8,308,308,308,308,308,4,0,0,0,0,0,0,0,0,0,0,0,0,0,0,0,0,4,304,0,8160,112,256
1028,316,316,316,316,8,308,312,308,308,308,4,4,4,4,0,0,0,0,0,0,0,0,0,0,0,4,0,4,304,0,8224,112,258
1036,316,317,316,316,16,301,302,301,301,301,5,5,5,4,0,0,0,0,0,0,0,0,0,0,0,4,1,1,296,0,8288,112,260
1044,316,318,316,316,316,2,2,2,2,2,2,2,2,0,0,0,0,0,0,0,0,0,0,0,0,0,2,0,0,0,8352,112,262
1052,316,316,316,316,8,308,312,308,308,308,4,4,4,4,0,0,0,0,0,0,0,0,0,0,0,4,0,4,304,0,8416,112,264
1060,316,391,316,316,316,75,75,75,75,75,75,75,75,0,0,0,0,0,0,0,0,0,0,0,0,0,75,0,0,0,8480,112,266
1068,316,319,316,316,16,303,309,303,303,303,11,11,7,4,0,0,0,0,0,0,0,0,0,0,0,4,3,7,295,0,8544,112,268
1076,316,328,316,316,316,12,12,12,12,12,12,12,12,0,0,0,0,0,0,0,0,0,0,0,0,0,12,0,0,0,8608,112,270
1084,316,326,316,316,68,258,258,258,258,258,14,14,14,4,0,0,0,0,0,0,0,0,0,0,0,4,10,0,244,0,8672,112,272
1092,316,328,316,316,316,12,12,12,12,12,12,12,12,0,0,0,0,0,0,0,0,0,0,0,0,0,12,0,0,0,8736,112,274
1100,316,334,316,316,72,262,262,262,262,262,22,22,22,4,0,0,0,0,0,0,0,0,0,0,0,4,18,0,240,0,8800,112,276
1108,316,319,316,316,16,303,307,303,303,303,11,11,7,4,0,0,0,0,0,0,0,0,0,0,0,4,3,6,294,0,8864,112,278
1116,316,323,316,316,316,7,7,7,7,7,7,7,7,0,0,0,0,0,0,0,0,0,0,0,0,0,7,0,0,0,8928,112,280
1124,316,329,316,316,48,281,282,281,281,281,17,17,17,4,0,0,0,0,0,0,0,0,0,0,0,4,13,1,264,0,8992,112,282
1132,316,353,316,316,163,190,190,190,190,190,40,40,40,3,0,0,0,0,0,0,0,0,0,0,0,3,37,0,150,0,9056,112,284
1140,316,316,316,316,8,308,312,308,308,308,4,4,4,4,0,0,0,0,0,0,0,0,0,0,0,4,0,4,304,0,9120,112,286
1148,316,378,316,316,193,185,187,185,185,185,65,65,65,3,0,0,0,0,0,0,0,0,0,0,0,3,62,2,120,0,9184,112,288
1156,316,316,316,316,8,308,311,308,308,308,4,4,4,4,0,0,0,0,0,0,0,0,0,0,0,4,0,3,304,0,9248,112,290
1164,316,316,316,316,8,308,310,308,308,308,4,4,4,4,0,0,0,0,0,0,0,0,0,0,0,4,0,2,304,0,9312,112,292
1172,316,333,316,316,316,17,17,17,17,17,17,17,17,0,0,0,0,0,0,0,0,0,0,0,0,0,17,0,0,0,9376,112,294
1180,316,344,316,316,316,28,28,28,28,28,28,28,28,0,0,0,0,0,0,0,0,0,0,0,0,0,28,0,0,0,9440,112,296
1188,316,322,316,316,24,298,298,298,298,298,10,10,10,4,0,0,0,0,0,0,0,0,0,0,0,4,6,0,288,0,9504,112,298
1196,316,318,316,316,16,302,302,302,302,302,10,10,6,4,0,0,0,0,0,0,0,0,0,0,0,4,2,4,292,0,9568,112,300
1204,316,353,316,316,127,226,226,226,226,226,40,40,40,3,0,0,0,0,0,0,0,0,0,0,0,3,37,0,186,0,9632,112,302
1212,316,372,316,316,303,69,69,69,69,69,57,57,57,1,0,0,0,0,0,0,0,0,0,0,0,1,56,0,12,0,9696,112,304
1220,316,316,316,316,24,292,294,292,292,292,8,8,4,4,0,0,0,0,0,0,0,0,0,0,0,4,0,5,285,0,9760,112,306
1228,316,328,316,316,40,288,290,288,288,288,16,16,16,4,0,0,0,0,0,0,0,0,0,0,0,4,12,2,272,0,9824,112,308
1236,316,366,316,316,139,227,229,227,227,227,53,53,53,3,0,0,0,0,0,0,0,0,0,0,0,3,50,2,174,0,9888,112,310
1244,316,316,316,316,24,292,292,292,292,292,8,8,4,4,0,0,0,0,0,0,0,0,0,0,0,4,0,4,284,0,9952,112,312
1252,316,316,316,316,8,308,311,308,308,308,4,4,4,4,0,0,0,0,0,0,0,0,0,0,0,4,0,3,304,0,10016,112,314
1260,316,318,316,316,16,302,304,302,302,302,10,10,6,4,0,0,0,0,0,0,0,0,0,0,0,4,2,5,293,0,10080,112,316
1268,316,324,316,316,316,8,8,8,8,8,8,8,8,0,0,0,0,0,0,0,0,0,0,0,0,0,8,0,0,0,10144,112,318
1276,316,404,316,316,120,284,287,284,284,284,92,92,92,4,0,0,0,0,0,0,0,0,0,0,0,4,88,3,192,0,10208,112,320
1284,316,316,316,316,8,308,310,308,308,308,4,4,4,4,0,0,0,0,0,0,0,0,0,0,0,4,0,2,304,0,10272,112,322
1292,316,316,316,316,8,308,311,308,308,308,4,4,4,4,0,0,0,0,0,0,0,0,0,0,0,4,0,3,304,0,10336,112,324
1300,316,358,316,316,133,225,226,225,225,225,45,45,45,3,0,0,0,0,0,0,0,0,0,0,0,3,42,1,180,0,10400,112,326
1308,316,369,316,316,316,53,53,53,53,53,53,53,53,0,0,0,0,0,0,0,0,0,0,0,0,0,53,0,0,0,10464,112,328
1316,316,343,316,316,72,271,274,271,271,271,31,31,31,4,0,0,0,0,0,0,0,0,0,0,0,4,27,3,240,0,10528,112,330
1324,316,328,316,316,316,12,12,12,12,12,12,12,12,0,0,0,0,0,0,0,0,0,0,0,0,0,12,0,0,0,10592,112,332
1332,316,325,316,316,316,9,9,9,9,9,9,9,9,0,0,0,0,0,0,0,0,0,0,0,0,0,9,0,0,0,10656,112,334
1340,316,383,316,316,315,68,68,68,68,68,68,68,68,1,0,0,0,0,0,0,0,0,0,0,0,1,67,0,0,0,10720,112,336
1348,316,316,316,316,8,308,316,308,308,308,8,8,4,4,0,0,0,0,0,0,0,0,0,0,0,4,0,8,304,0,10784,112,338
1356,316,318,316,316,24,294,295,294,294,294,6,6,6,4,0,0,0,0,0,0,0,0,0,0,0,4,2,1,288,0,10848,112,340
1364,316,316,316,316,8,308,312,308,308,308,4,4,4,4,0,0,0,0,0,0,0,0,0,0,0,4,0,4,304,0,10912,112,342
1372,316,319,316,316,32,287,288,287,287,287,7,7,7,4,0,0,0,0,0,0,0,0,0,0,0,4,3,1,280,0,10976,112,344
1380,316,316,316,316,8,308,312,308,308,308,4,4,4,4,0,0,0,0,0,0,0,0,0,0,0,4,0,4,304,0,11040,112,346
1388,316,316,316,316,8,308,316,308,308,308,8,8,4,4,0,0,0,0,0,0,0,0,0,0,0,4,0,8,304,0,11104,112,348
1396,316,328,316,316,72,256,256,256,256,256,16,16,16,4,0,0,0,0,0,0,0,0,0,0,0,4,12,0,240,0,11168,112,350
1404,316,316,316,316,8,308,314,308,308,308,8,8,4,4,0,0,0,0,0,0,0,0,0,0,0,4,0,7,303,0,11232,112,352
1412,316,316,316,316,8,308,316,308,308,308,8,8,4,4,0,0,0,0,0,0,0,0,0,0,0,4,0,8,304,0,11296,112,354
1420,316,324,316,316,32,292,294,292,292,292,12,12,12,4,0,0,0,0,0,0,0,0,0,0,0,4,8,2,280,0,11360,112,356
1428,316,323,316,316,16,307,311,307,307,307,15,15,11,4,0,0,0,0,0,0,0,0,0,0,0,4,7,6,294,0,11424,112,358
1436,316,318,316,316,24,294,294,294,294,294,6,6,6,4,0,0,0,0,0,0,0,0,0,0,0,4,2,0,288,0,11488,112,360
1444,316,335,316,316,316,19,19,19,19,19,19,19,19,0,0,0,0,0,0,0,0,0,0,0,0,0,19,0,0,0,11552,112,362
1452,316,318,316,316,24,294,295,294,294,294,6,6,6,4,0,0,0,0,0,0,0,0,0,0,0,4,2,1,288,0,11616,112,364
1460,316,321,316,316,316,5,5,5,5,5,5,5,5,0,0,0,0,0,0,0,0,0,0,0,0,0,5,0,0,0,11680,112,366
1468,316,324,316,316,24,300,303,300,300,300,12,12,12,4,0,0,0,0,0,0,0,0,0,0,0,4,8,3,288,0,11744,112,368
1476,316,316,316,316,8,308,310,308,308,308,8,8,4,4,0,0,0,0,0,0,0,0,0,0,0,4,0,5,301,0,11808,112,370
1484,316,341,316,316,127,214,215,214,214,214,28,28,28,3,0,0,0,0,0,0,0,0,0,0,0,3,25,1,186,0,11872,112,372
1492,316,318,316,316,16,302,304,302,302,302,10,10,6,4,0,0,0,0,0,0,0,0,0,0,0,4,2,5,293,0,11936,112,374
1500,316,321,316,316,24,297,299,297,297,297,9,9,9,4,0,0,0,0,0,0,0,0,0,0,0,4,5,2,288,0,12000,112,376
1508,316,322,316,316,16,306,310,306,306,306,14,14,10,4,0,0,0,0,0,0,0,0,0,0,0,4,6,6,294,0,12064,112,378
1516,316,357,316,316,316,41,41,41,41,41,41,41,41,0,0,0,0,0,0,0,0,0,0,0,0,0,41,0,0,0,12128,112,380
1524,316,385,316,316,205,180,180,180,180,180,72,72,72,3,0,0,0,0,0,0,0,0,0,0,0,3,69,0,108,0,12192,112,382
1532,316,318,316,316,12,306,314,306,306,306,10,10,6,4,0,0,0,0,0,0,0,0,0,0,0,4,2,8,300,0,12256,112,384
1540,316,316,316,316,8,308,314,308,308,308,8,8,4,4,0,0,0,0,0,0,0,0,0,0,0,4,0,7,303,0,12320,112,386
1548,316,320,316,316,23,297,298,297,297,297,9,9,9,4,0,0,0,0,0,0,0,0,0,0,0,4,5,1,288,0,12384,112,388
1556,316,319,316,316,24,295,296,295,295,295,7,7,7,4,0,0,0,0,0,0,0,0,0,0,0,4,3,1,288,0,12448,112,390
1564,316,317,316,316,12,305,307,305,305,305,9,9,5,4,0,0,0,0,0,0,0,0,0,0,0,4,1,5,297,0,12512,112,392
1572,316,316,316,316,8,308,316,308,308,308,8,8,4,4,0,0,0,0,0,0,0,0,0,0,0,4,0,8,304,0,12576,112,394
1580,316,321,316,316,316,5,5,5,5,5,5,5,5,0,0,0,0,0,0,0,0,0,0,0,0,0,5,0,0,0,12640,112,396
1588,316,381,316,316,316,65,65,65,65,65,65,65,65,0,0,0,0,0,0,0,0,0,0,0,0,0,65,0,0,0,12704,112,398
1596,316,316,316,316,8,308,312,308,308,308,8,8,4,4,0,0,0,0,0,0,0,0,0,0,0,4,0,6,302,0,12768,112,400
1604,316,316,316,316,8,308,310,308,308,308,8,8,4,4,0,0,0,0,0,0,0,0,0,0,0,4,0,5,301,0,12832,112,402
1612,316,335,316,316,316,19,19,19,19,19,19,19,19,0,0,0,0,0,0,0,0,0,0,0,0,0,19,0,0,0,12896,112,404
1620,316,322,316,316,24,298,300,298,298,298,14,14,10,4,0,0,0,0,0,0,0,0,0,0,0,4,6,5,285,0,12960,112,406
1628,316,320,316,316,40,280,280,280,280,280,12,12,8,4,0,0,0,0,0,0,0,0,0,0,0,4,4,4,268,0,13024,112,408
1636,316,316,316,316,8,308,316,308,308,308,8,8,4,4,0,0,0,0,0,0,0,0,0,0,0,4,0,8,304,0,13088,112,410
1644,316,316,316,316,8,308,310,308,308,308,8,8,4,4,0,0,0,0,0,0,0,0,0,0,0,4,0,5,301,0,13152,112,412
1652,316,329,316,316,316,13,13,13,13,13,13,13,13,0,0,0,0,0,0,0,0,0,0,0,0,0,13,0,0,0,13216,112,414
1660,316,362,316,316,250,112,112,112,112,112,48,48,48,2,0,0,0,0,0,0,0,0,0,0,0,2,46,0,64,0,13280,112,416
1668,316,319,316,316,24,295,296,295,295,295,7,7,7,4,0,0,0,0,0,0,0,0,0,0,0,4,3,1,288,0,13344,112,418
1676,316,322,316,316,31,291,292,291,291,291,11,11,11,4,0,0,0,0,0,0,0,0,0,0,0,4,7,1,280,0,13408,112,420
1684,316,318,316,316,316,2,2,2,2,2,2,2,2,0,0,0,0,0,0,0,0,0,0,0,0,0,2,0,0,0,13472,112,422
1692,316,316,316,316,8,308,310,308,308,308,4,4,4,4,0,0,0,0,0,0,0,0,0,0,0,4,0,2,304,0,13536,112,424
1700,316,320,316,316,316,4,4,4,4,4,4,4,4,0,0,0,0,0,0,0,0,0,0,0,0,0,4,0,0,0,13600,112,426
1708,316,316,316,316,8,308,310,308,308,308,8,8,4,4,0,0,0,0,0,0,0,0,0,0,0,4,0,5,301,0,13664,112,428
1716,316,316,316,316,8,308,312,308,308,308,4,4,4,4,0,0,0,0,0,0,0,0,0,0,0,4,0,4,304,0,13728,112,430
1724,316,316,316,316,8,308,314,308,308,308,8,8,4,4,0,0,0,0,0,0,0,0,0,0,0,4,0,7,303,0,13792,112,432
1732,316,316,316,316,8,308,316,308,308,308,8,8,4,4,0,0,0,0,0,0,0,0,0,0,0,4,0,8,304,0,13856,112,434
1740,316,322,316,316,24,298,300,298,298,298,14,14,10,4,0,0,0,0,0,0,0,0,0,0,0,4,6,5,285,0,13920,112,436
1748,316,318,316,316,12,306,310,306,306,306,10,10,6,4,0,0,0,0,0,0,0,0,0,0,0,4,2,6,298,0,13984,112,438
1756,316,333,316,316,316,17,17,17,17,17,17,17,17,0,0,0,0,0,0,0,0,0,0,0,0,0,17,0,0,0,14048,112,440
1764,316,324,316,316,32,292,293,292,292,292,12,12,12,4,0,0,0,0,0,0,0,0,0,0,0,4,8,1,280,0,14112,112,442
1772,316,316,316,316,8,308,316,308,308,308,8,8,4,4,0,0,0,0,0,0,0,0,0,0,0,4,0,8,304,0,14176,112,444
1780,316,320,316,316,316,4,4,4,4,4,4,4,4,0,0,0,0,0,0,0,0,0,0,0,0,0,4,0,0,0,14240,112,446
1788,316,386,316,316,96,290,293,290,290,290,74,74,74,4,0,0,0,0,0,0,0,0,0,0,0,4,70,3,216,0,14304,112,448
1796,316,316,316,316,8,308,311,308,308,308,4,4,4,4,0,0,0,0,0,0,0,0,0,0,0,4,0,3,304,0,14368,112,450
1804,316,316,316,316,8,308,310,308,308,308,4,4,4,4,0,0,0,0,0,0,0,0,0,0,0,4,0,2,304,0,14432,112,452
1812,316,321,316,316,316,5,5,5,5,5,5,5,5,0,0,0,0,0,0,0,0,0,0,0,0,0,5,0,0,0,14496,112,454
1820,316,316,316,316,8,308,309,308,308,308,4,4,4,4,0,0,0,0,0,0,0,0,0,0,0,4,0,1,304,0,14560,112,456
1828,316,316,316,316,8,308,316,308,308,308,8,8,4,4,0,0,0,0,0,0,0,0,0,0,0,4,0,8,304,0,14624,112,458
1836,316,326,316,316,24,302,304,302,302,302,14,14,14,4,0,0,0,0,0,0,0,0,0,0,0,4,10,2,288,0,14688,112,460
1844,316,316,316,316,8,308,316,308,308,308,8,8,4,4,0,0,0,0,0,0,0,0,0,0,0,4,0,8,304,0,14752,112,462
1852,316,322,316,316,316,6,6,6,6,6,6,6,6,0,0,0,0,0,0,0,0,0,0,0,0,0,6,0,0,0,14816,112,464
1860,316,316,316,316,8,308,312,308,308,308,4,4,4,4,0,0,0,0,0,0,0,0,0,0,0,4,0,4,304,0,14880,112,466
1868,316,320,316,316,23,297,298,297,297,297,9,9,9,4,0,0,0,0,0,0,0,0,0,0,0,4,5,1,288,0,14944,112,468
1876,316,316,316,316,8,308,312,308,308,308,8,8,4,4,0,0,0,0,0,0,0,0,0,0,0,4,0,6,302,0,15008,112,470
1884,316,318,316,316,316,2,2,2,2,2,2,2,2,0,0,0,0,0,0,0,0,0,0,0,0,0,2,0,0,0,15072,112,472
1892,316,355,316,316,316,39,39,39,39,39,39,39,39,0,0,0,0,0,0,0,0,0,0,0,0,0,39,0,0,0,15136,112,474
1900,316,320,316,316,23,297,298,297,297,297,9,9,9,4,0,0,0,0,0,0,0,0,0,0,0,4,5,1,288,0,15200,112,476
1908,316,326,316,316,316,10,10,10,10,10,10,10,10,0,0,0,0,0,0,0,0,0,0,0,0,0,10,0,0,0,15264,112,478
1916,316,450,316,316,175,275,277,275,275,275,137,137,137,3,0,0,0,0,0,0,0,0,0,0,0,3,134,2,138,0,15328,112,480
1924,316,321,316,316,24,297,299,297,297,297,9,9,9,4,0,0,0,0,0,0,0,0,0,0,0,4,5,2,288,0,15392,112,482
1932,316,325,316,316,24,301,304,301,301,301,13,13,13,4,0,0,0,0,0,0,0,0,0,0,0,4,9,3,288,0,15456,112,484
1940,316,342,316,316,316,26,26,26,26,26,26,26,26,0,0,0,0,0,0,0,0,0,0,0,0,0,26,0,0,0,15520,112,486
1948,316,320,316,316,316,4,4,4,4,4,4,4,4,0,0,0,0,0,0,0,0,0,0,0,0,0,4,0,0,0,15584,112,488
1956,316,370,316,316,242,128,128,128,128,128,56,56,56,2,0,0,0,0,0,0,0,0,0,0,0,2,54,0,72,0,15648,112,490
1964,316,316,316,316,8,308,312,308,308,308,8,8,4,4,0,0,0,0,0,0,0,0,0,0,0,4,0,6,302,0,15712,112,492
1972,316,316,316,316,8,308,316,308,308,308,8,8,4,4,0,0,0,0,0,0,0,0,0,0,0,4,0,8,304,0,15776,112,494
1980,316,316,316,316,8,308,310,308,308,308,4,4,4,4,0,0,0,0,0,0,0,0,0,0,0,4,0,2,304,0,15840,112,496
1988,316,316,316,316,8,308,312,308,308,308,8,8,4,4,0,0,0,0,0,0,0,0,0,0,0,4,0,6,302,0,15904,112,498
1996,316,332,316,316,316,16,16,16,16,16,16,16,16,0,0,0,0,0,0,0,0,0,0,0,0,0,16,0,0,0,15968,112,500
2004,316,316,316,316,8,308,311,308,308,308,4,3,3,3,0,0,0,0,0,0,0,0,0,0,0,3,0,4,304,0,16032,112,502
2012,316,351,316,316,316,35,35,35,35,35,35,35,35,0,0,0,0,0,0,0,0,0,0,0,0,0,35,0,0,0,16096,112,504
2020,316,325,316,316,56,269,269,269,269,269,13,13,13,4,0,0,0,0,0,0,0,0,0,0,0,4,9,0,256,0,16160,112,506
2028,316,316,316,316,8,308,312,308,308,308,4,4,4,4,0,0,0,0,0,0,0,0,0,0,0,4,0,4,304,0,16224,112,508
2036,316,324,316,316,32,292,293,292,292,292,12,12,12,4,0,0,0,0,0,0,0,0,0,0,0,4,8,1,280,0,16288,112,510
2044,316,316,316,316,8,308,308,308,308,308,4,0,0,0,0,0,0,0,0,0,0,0,0,0,0,0,0,4,304,0,16352,112,512
2052,316,319,316,316,16,303,305,303,303,303,7,7,7,4,0,0,0,0,0,0,0,0,0,0,0,4,3,2,296,0,16416,112,514
2060,316,316,316,316,8,308,312,308,308,308,4,4,4,4,0,0,0,0,0,0,0,0,0,0,0,4,0,4,304,0,16480,112,516
2068,316,324,316,316,24,300,306,300,300,300,16,16,12,4,0,0,0,0,0,0,0,0,0,0,0,4,8,7,287,0,16544,112,518
2076,316,317,316,316,16,301,302,301,301,301,5,5,5,4,0,0,0,0,0,0,0,0,0,0,0,4,1,1,296,0,16608,112,520
2084,316,325,316,316,24,301,305,301,301,301,13,13,13,4,0,0,0,0,0,0,0,0,0,0,0,4,9,4,288,0,16672,112,522
2092,316,318,316,316,316,2,2,2,2,2,2,2,2,0,0,0,0,0,0,0,0,0,0,0,0,0,2,0,0,0,16736,112,524
2100,316,347,316,316,316,31,31,31,31,31,31,31,31,0,0,0,0,0,0,0,0,0,0,0,0,0,31,0,0,0,16800,112,526
2108,316,316,316,316,8,308,312,308,308,308,4,4,4,4,0,0,0,0,0,0,0,0,0,0,0,4,0,4,304,0,16864,112,528
2116,316,316,316,316,8,308,311,308,308,308,4,3,3,3,0,0,0,0,0,0,0,0,0,0,0,3,0,4,304,0,16928,112,530
2124,316,391,316,316,316,75,75,75,75,75,75,75,75,0,0,0,0,0,0,0,0,0,0,0,0,0,75,0,0,0,16992,112,532
2132,316,345,316,316,64,281,284,281,281,281,33,33,33,4,0,0,0,0,0,0,0,0,0,0,0,4,29,3,248,0,17056,112,534
2140,316,319,316,316,16,303,309,303,303,303,11,11,7,4,0,0,0,0,0,0,0,0,0,0,0,4,3,7,295,0,17120,112,536
2148,316,323,316,316,20,303,307,303,303,303,11,11,11,4,0,0,0,0,0,0,0,0,0,0,0,4,7,4,292,0,17184,112,538
2156,316,328,316,316,316,12,12,12,12,12,12,12,12,0,0,0,0,0,0,0,0,0,0,0,0,0,12,0,0,0,17248,112,540
2164,316,351,316,316,88,263,265,263,263,263,39,39,39,4,0,0,0,0,0,0,0,0,0,0,0,4,35,2,224,0,17312,112,542
2172,316,326,316,316,68,258,258,258,258,258,14,14,14,4,0,0,0,0,0,0,0,0,0,0,0,4,10,0,244,0,17376,112,544
2180,316,321,316,316,24,297,299,297,297,297,9,9,9,4,0,0,0,0,0,0,0,0,0,0,0,4,5,2,288,0,17440,112,546
2188,316,328,316,316,316,12,12,12,12,12,12,12,12,0,0,0,0,0,0,0,0,0,0,0,0,0,12,0,0,0,17504,112,548
2196,316,371,316,316,127,244,247,244,244,244,58,58,58,3,0,0,0,0,0,0,0,0,0,0,0,3,55,3,186,0,17568,112,550
2204,316,334,316,316,72,262,262,262,262,262,22,22,22,4,0,0,0,0,0,0,0,0,0,0,0,4,18,0,240,0,17632,112,552
2212,316,349,316,316,120,229,230,229,229,229,37,37,37,4,0,0,0,0,0,0,0,0,0,0,0,4,33,1,192,0,17696,112,554
2220,316,319,316,316,16,303,307,303,303,303,11,11,7,4,0,0,0,0,0,0,0,0,0,0,0,4,3,6,294,0,17760,112,556
2228,316,380,316,316,222,158,158,158,158,158,66,66,66,2,0,0,0,0,0,0,0,0,0,0,0,2,64,0,92,0,17824,112,558
2236,316,323,316,316,316,7,7,7,7,7,7,7,7,0,0,0,0,0,0,0,0,0,0,0,0,0,7,0,0,0,17888,112,560
2244,316,322,316,316,316,6,6,6,6,6,6,6,6,0,0,0,0,0,0,0,0,0,0,0,0,0,6,0,0,0,17952,112,562
2252,316,329,316,316,48,281,282,281,281,281,17,17,17,4,0,0,0,0,0,0,0,0,0,0,0,4,13,1,264,0,18016,112,564
2260,316,320,316,316,316,4,4,4,4,4,4,4,4,0,0,0,0,0,0,0,0,0,0,0,0,0,4,0,0,0,18080,112,566
2268,316,353,316,316,163,190,190,190,190,190,40,40,40,3,0,0,0,0,0,0,0,0,0,0,0,3,37,0,150,0,18144,112,568
2276,316,330,316,316,40,290,293,290,290,290,18,18,18,4,0,0,0,0,0,0,0,0,0,0,0,4,14,3,272,0,18208,112,570
2284,316,316,316,316,8,308,312,308,308,308,4,4,4,4,0,0,0,0,0,0,0,0,0,0,0,4,0,4,304,0,18272,112,572
2292,316,321,316,316,316,5,5,5,5,5,5,5,5,0,0,0,0,0,0,0,0,0,0,0,0,0,5,0,0,0,18336,112,574
2300,316,378,316,316,193,185,187,185,185,185,65,65,65,3,0,0,0,0,0,0,0,0,0,0,0,3,62,2,120,0,18400,112,576
2308,316,411,316,316,316,95,95,95,95,95,95,95,95,0,0,0,0,0,0,0,0,0,0,0,0,0,95,0,0,0,18464,112,578
2316,316,316,316,316,8,308,311,308,308,308,4,4,4,4,0,0,0,0,0,0,0,0,0,0,0,4,0,3,304,0,18528,112,580
2324,316,336,316,316,316,20,20,20,20,20,20,20,20,0,0,0,0,0,0,0,0,0,0,0,0,0,20,0,0,0,18592,112,582
2332,316,316,316,316,8,308,310,308,308,308,4,4,4,4,0,0,0,0,0,0,0,0,0,0,0,4,0,2,304,0,18656,112,584
2340,316,321,316,316,316,5,5,5,5,5,5,5,5,0,0,0,0,0,0,0,0,0,0,0,0,0,5,0,0,0,18720,112,586
2348,316,333,316,316,316,17,17,17,17,17,17,17,17,0,0,0,0,0,0,0,0,0,0,0,0,0,17,0,0,0,18784,112,588
2356,316,358,316,316,104,254,256,254,254,254,46,46,46,4,0,0,0,0,0,0,0,0,0,0,0,4,42,2,208,0,18848,112,590
2364,316,344,316,316,316,28,28,28,28,28,28,28,28,0,0,0,0,0,0,0,0,0,0,0,0,0,28,0,0,0,18912,112,592
2372,316,323,316,316,316,7,7,7,7,7,7,7,7,0,0,0,0,0,0,0,0,0,0,0,0,0,7,0,0,0,18976,112,594
2380,316,322,316,316,24,298,298,298,298,298,10,10,10,4,0,0,0,0,0,0,0,0,0,0,0,4,6,0,288,0,19040,112,596
2388,316,318,316,316,316,2,2,2,2,2,2,2,2,0,0,0,0,0,0,0,0,0,0,0,0,0,2,0,0,0,19104,112,598
2396,316,318,316,316,16,302,302,302,302,302,10,10,6,4,0,0,0,0,0,0,0,0,0,0,0,4,2,4,292,0,19168,112,600
2404,316,318,316,316,16,302,303,302,302,302,6,6,6,4,0,0,0,0,0,0,0,0,0,0,0,4,2,1,296,0,19232,112,602
2412,316,353,316,316,127,226,226,226,226,226,40,40,40,3,0,0,0,0,0,0,0,0,0,0,0,3,37,0,186,0,19296,112,604
2420,316,334,316,316,40,294,297,294,294,294,22,22,22,4,0,0,0,0,0,0,0,0,0,0,0,4,18,3,272,0,19360,112,606
2428,316,372,316,316,303,69,69,69,69,69,57,57,57,1,0,0,0,0,0,0,0,0,0,0,0,1,56,0,12,0,19424,112,608
2436,316,333,316,316,316,17,17,17,17,17,17,17,17,0,0,0,0,0,0,0,0,0,0,0,0,0,17,0,0,0,19488,112,610
2444,316,316,316,316,24,292,294,292,292,292,8,8,4,4,0,0,0,0,0,0,0,0,0,0,0,4,0,5,285,0,19552,112,612
2452,316,324,316,316,316,8,8,8,8,8,8,8,8,0,0,0,0,0,0,0,0,0,0,0,0,0,8,0,0,0,19616,112,614
2460,316,328,316,316,40,288,290,288,288,288,16,16,16,4,0,0,0,0,0,0,0,0,0,0,0,4,12,2,272,0,19680,112,616
2468,316,336,316,316,316,20,20,20,20,20,20,20,20,0,0,0,0,0,0,0,0,0,0,0,0,0,20,0,0,0,19744,112,618
2476,316,366,316,316,139,227,229,227,227,227,53,53,53,3,0,0,0,0,0,0,0,0,0,0,0,3,50,2,174,0,19808,112,620
2484,316,316,316,316,8,308,312,308,308,308,4,4,4,4,0,0,0,0,0,0,0,0,0,0,0,4,0,4,304,0,19872,112,622
2492,316,316,316,316,24,292,292,292,292,292,8,8,4,4,0,0,0,0,0,0,0,0,0,0,0,4,0,4,284,0,19936,112,624
2500,316,355,316,316,80,275,277,275,275,275,43,43,43,4,0,0,0,0,0,0,0,0,0,0,0,4,39,2,232,0,20000,112,626
2508,316,316,316,316,8,308,311,308,308,308,4,4,4,4,0,0,0,0,0,0,0,0,0,0,0,4,0,3,304,0,20064,112,628
2516,316,316,316,316,24,292,296,292,292,292,8,8,4,4,0,0,0,0,0,0,0,0,0,0,0,4,0,6,286,0,20128,112,630
2524,316,318,316,316,16,302,304,302,302,302,10,10,6,4,0,0,0,0,0,0,0,0,0,0,0,4,2,5,293,0,20192,112,632
2532,316,321,316,316,316,5,5,5,5,5,5,5,5,0,0,0,0,0,0,0,0,0,0,0,0,0,5,0,0,0,20256,112,634
2540,316,324,316,316,316,8,8,8,8,8,8,8,8,0,0,0,0,0,0,0,0,0,0,0,0,0,8,0,0,0,20320,112,636
2548,316,399,316,316,151,248,250,248,248,248,86,86,86,3,0,0,0,0,0,0,0,0,0,0,0,3,83,2,162,0,20384,112,638
2556,316,404,316,316,120,284,287,284,284,284,92,92,92,4,0,0,0,0,0,0,0,0,0,0,0,4,88,3,192,0,20448,112,640
2564,316,329,316,316,316,13,13,13,13,13,13,13,13,0,0,0,0,0,0,0,0,0,0,0,0,0,13,0,0,0,20512,112,642
2572,316,316,316,316,8,308,310,308,308,308,4,4,4,4,0,0,0,0,0,0,0,0,0,0,0,4,0,2,304,0,20576,112,644
2580,316,316,316,316,8,308,310,308,308,308,4,4,4,4,0,0,0,0,0,0,0,0,0,0,0,4,0,2,304,0,20640,112,646
2588,316,316,316,316,8,308,311,308,308,308,4,4,4,4,0,0,0,0,0,0,0,0,0,0,0,4,0,3,304,0,20704,112,648
2596,316,316,316,316,8,308,316,308,308,308,8,8,4,4,0,0,0,0,0,0,0,0,0,0,0,4,0,8,304,0,20768,112,650
2604,316,358,316,316,133,225,226,225,225,225,45,45,45,3,0,0,0,0,0,0,0,0,0,0,0,3,42,1,180,0,20832,112,652
2612,316,317,316,316,316,1,1,1,1,1,1,1,1,0,0,0,0,0,0,0,0,0,0,0,0,0,1,0,0,0,20896,112,654
2620,316,369,316,316,316,53,53,53,53,53,53,53,53,0,0,0,0,0,0,0,0,0,0,0,0,0,53,0,0,0,20960,112,656
2628,316,316,316,316,8,308,314,308,308,308,8,8,4,4,0,0,0,0,0,0,0,0,0,0,0,4,0,7,303,0,21024,112,658
2636,316,343,316,316,72,271,274,271,271,271,31,31,31,4,0,0,0,0,0,0,0,0,0,0,0,4,27,3,240,0,21088,112,660
2644,316,316,316,316,8,308,316,308,308,308,8,8,4,4,0,0,0,0,0,0,0,0,0,0,0,4,0,8,304,0,21152,112,662
2652,316,328,316,316,316,12,12,12,12,12,12,12,12,0,0,0,0,0,0,0,0,0,0,0,0,0,12,0,0,0,21216,112,664
2660,316,316,316,316,8,308,312,308,308,308,4,4,4,4,0,0,0,0,0,0,0,0,0,0,0,4,0,4,304,0,21280,112,666
2668,316,325,316,316,316,9,9,9,9,9,9,9,9,0,0,0,0,0,0,0,0,0,0,0,0,0,9,0,0,0,21344,112,668
2676,316,317,316,316,316,1,1,1,1,1,1,1,1,0,0,0,0,0,0,0,0,0,0,0,0,0,1,0,0,0,21408,112,670
2684,316,383,316,316,315,68,68,68,68,68,68,68,68,1,0,0,0,0,0,0,0,0,0,0,0,1,67,0,0,0,21472,112,672
2692,316,346,316,316,64,282,290,282,282,282,38,38,34,4,0,0,0,0,0,0,0,0,0,0,0,4,30,8,248,0,21536,112,674
2700,316,316,316,316,8,308,316,308,308,308,8,8,4,4,0,0,0,0,0,0,0,0,0,0,0,4,0,8,304,0,21600,112,676
2708,316,316,316,316,8,308,312,308,308,308,4,4,4,4,0,0,0,0,0,0,0,0,0,0,0,4,0,4,304,0,21664,112,678
2716,316,318,316,316,24,294,295,294,294,294,6,6,6,4,0,0,0,0,0,0,0,0,0,0,0,4,2,1,288,0,21728,112,680
2724,316,316,316,316,8,308,316,308,308,308,8,8,4,4,0,0,0,0,0,0,0,0,0,0,0,4,0,8,304,0,21792,112,682
2732,316,316,316,316,8,308,312,308,308,308,4,4,4,4,0,0,0,0,0,0,0,0,0,0,0,4,0,4,304,0,21856,112,684
2740,316,326,316,316,24,302,308,302,302,302,18,18,14,4,0,0,0,0,0,0,0,0,0,0,0,4,10,7,287,0,21920,112,686
2748,316,319,316,316,32,287,288,287,287,287,7,7,7,4,0,0,0,0,0,0,0,0,0,0,0,4,3,1,280,0,21984,112,688
2756,316,328,316,316,316,12,12,12,12,12,12,12,12,0,0,0,0,0,0,0,0,0,0,0,0,0,12,0,0,0,22048,112,690
2764,316,316,316,316,8,308,312,308,308,308,4,4,4,4,0,0,0,0,0,0,0,0,0,0,0,4,0,4,304,0,22112,112,692
2772,316,379,316,316,139,240,242,240,240,240,66,66,66,3,0,0,0,0,0,0,0,0,0,0,0,3,63,2,174,0,22176,112,694
2780,316,316,316,316,8,308,316,308,308,308,8,8,4,4,0,0,0,0,0,0,0,0,0,0,0,4,0,8,304,0,22240,112,696
2788,316,324,316,316,32,292,293,292,292,292,12,12,12,4,0,0,0,0,0,0,0,0,0,0,0,4,8,1,280,0,22304,112,698
2796,316,328,316,316,72,256,256,256,256,256,16,16,16,4,0,0,0,0,0,0,0,0,0,0,0,4,12,0,240,0,22368,112,700
2804,316,333,316,316,316,17,17,17,17,17,17,17,17,0,0,0,0,0,0,0,0,0,0,0,0,0,17,0,0,0,22432,112,702
2812,316,316,316,316,8,308,314,308,308,308,8,8,4,4,0,0,0,0,0,0,0,0,0,0,0,4,0,7,303,0,22496,112,704
2820,316,350,316,316,157,193,193,193,193,193,40,40,37,3,0,0,0,0,0,0,0,0,0,0,0,3,34,3,153,0,22560,112,706
2828,316,316,316,316,8,308,316,308,308,308,8,8,4,4,0,0,0,0,0,0,0,0,0,0,0,4,0,8,304,0,22624,112,708
2836,316,329,316,316,316,13,13,13,13,13,13,13,13,0,0,0,0,0,0,0,0,0,0,0,0,0,13,0,0,0,22688,112,710
2844,316,324,316,316,32,292,294,292,292,292,12,12,12,4,0,0,0,0,0,0,0,0,0,0,0,4,8,2,280,0,22752,112,712
2852,316,321,316,316,24,297,299,297,297,297,9,9,9,4,0,0,0,0,0,0,0,0,0,0,0,4,5,2,288,0,22816,112,714
2860,316,323,316,316,16,307,311,307,307,307,15,15,11,4,0,0,0,0,0,0,0,0,0,0,0,4,7,6,294,0,22880,112,716
2868,316,363,316,316,187,176,176,176,176,176,50,50,50,3,0,0,0,0,0,0,0,0,0,0,0,3,47,0,126,0,22944,112,718
2876,316,318,316,316,24,294,294,294,294,294,6,6,6,4,0,0,0,0,0,0,0,0,0,0,0,4,2,0,288,0,23008,112,720
2884,316,316,316,316,8,308,311,308,308,308,4,4,4,4,0,0,0,0,0,0,0,0,0,0,0,4,0,3,304,0,23072,112,722
2892,316,335,316,316,316,19,19,19,19,19,19,19,19,0,0,0,0,0,0,0,0,0,0,0,0,0,19,0,0,0,23136,112,724
2900,316,386,316,316,316,70,70,70,70,70,70,70,70,0,0,0,0,0,0,0,0,0,0,0,0,0,70,0,0,0,23200,112,726
2908,316,318,316,316,24,294,295,294,294,294,6,6,6,4,0,0,0,0,0,0,0,0,0,0,0,4,2,1,288,0,23264,112,728
2916,316,329,316,316,48,281,282,281,281,281,17,17,17,4,0,0,0,0,0,0,0,0,0,0,0,4,13,1,264,0,23328,112,730
2924,316,321,316,316,316,5,5,5,5,5,5,5,5,0,0,0,0,0,0,0,0,0,0,0,0,0,5,0,0,0,23392,112,732
2932,316,316,316,316,8,308,314,308,308,308,8,8,4,4,0,0,0,0,0,0,0,0,0,0,0,4,0,7,303,0,23456,112,734
2940,316,324,316,316,24,300,303,300,300,300,12,12,12,4,0,0,0,0,0,0,0,0,0,0,0,4,8,3,288,0,23520,112,736
2948,316,418,316,316,316,102,102,102,102,102,102,102,102,0,0,0,0,0,0,0,0,0,0,0,0,0,102,0,0,0,23584,112,738
2956,316,316,316,316,8,308,310,308,308,308,8,8,4,4,0,0,0,0,0,0,0,0,0,0,0,4,0,5,301,0,23648,112,740
2964,316,316,316,316,316,0,0,0,0,0,0,0,0,0,0,0,0,0,0,0,0,0,0,0,0,0,0,0,0,0,23712,112,742
2972,316,341,316,316,127,214,215,214,214,214,28,28,28,3,0,0,0,0,0,0,0,0,0,0,0,3,25,1,186,0,23776,112,744
2980,316,340,316,316,316,24,24,24,24,24,24,24,24,0,0,0,0,0,0,0,0,0,0,0,0,0,24,0,0,0,23840,112,746
2988,316,318,316,316,16,302,304,302,302,302,10,10,6,4,0,0,0,0,0,0,0,0,0,0,0,4,2,5,293,0,23904,112,748
2996,316,320,316,316,316,4,4,4,4,4,4,4,4,0,0,0,0,0,0,0,0,0,0,0,0,0,4,0,0,0,23968,112,750
3004,316,321,316,316,24,297,299,297,297,297,9,9,9,4,0,0,0,0,0,0,0,0,0,0,0,4,5,2,288,0,24032,112,752
3012,316,327,316,316,316,11,11,11,11,11,11,11,11,0,0,0,0,0,0,0,0,0,0,0,0,0,11,0,0,0,24096,112,754
3020,316,322,316,316,16,306,310,306,306,306,14,14,10,4,0,0,0,0,0,0,0,0,0,0,0,4,6,6,294,0,24160,112,756
3028,316,329,316,316,316,13,13,13,13,13,13,13,13,0,0,0,0,0,0,0,0,0,0,0,0,0,13,0,0,0,24224,112,758
3036,316,357,316,316,316,41,41,41,41,41,41,41,41,0,0,0,0,0,0,0,0,0,0,0,0,0,41,0,0,0,24288,112,760
3044,316,316,316,316,8,308,312,308,308,308,4,4,4,4,0,0,0,0,0,0,0,0,0,0,0,4,0,4,304,0,24352,112,762
3052,316,385,316,316,205,180,180,180,180,180,72,72,72,3,0,0,0,0,0,0,0,0,0,0,0,3,69,0,108,0,24416,112,764
3060,316,319,316,316,24,295,296,295,295,295,7,7,7,4,0,0,0,0,0,0,0,0,0,0,0,4,3,1,288,0,24480,112,766
3068,316,318,316,316,12,306,314,306,306,306,10,10,6,4,0,0,0,0,0,0,0,0,0,0,0,4,2,8,300,0,24544,112,768
3076,316,325,316,316,316,9,9,9,9,9,9,9,9,0,0,0,0,0,0,0,0,0,0,0,0,0,9,0,0,0,24608,112,770
3084,316,316,316,316,8,308,314,308,308,308,8,8,4,4,0,0,0,0,0,0,0,0,0,0,0,4,0,7,303,0,24672,112,772
3092,316,317,316,316,12,305,307,305,305,305,9,9,5,4,0,0,0,0,0,0,0,0,0,0,0,4,1,5,297,0,24736,112,774
3100,316,320,316,316,23,297,298,297,297,297,9,9,9,4,0,0,0,0,0,0,0,0,0,0,0,4,5,1,288,0,24800,112,776
3108,316,333,316,316,316,17,17,17,17,17,17,17,17,0,0,0,0,0,0,0,0,0,0,0,0,0,17,0,0,0,24864,112,778
3116,316,319,316,316,24,295,296,295,295,295,7,7,7,4,0,0,0,0,0,0,0,0,0,0,0,4,3,1,288,0,24928,112,780
3124,316,323,316,316,316,7,7,7,7,7,7,7,7,0,0,0,0,0,0,0,0,0,0,0,0,0,7,0,0,0,24992,112,782
3132,316,317,316,316,12,305,307,305,305,305,9,9,5,4,0,0,0,0,0,0,0,0,0,0,0,4,1,5,297,0,25056,112,784
3140,316,316,316,316,8,308,316,308,308,308,8,8,4,4,0,0,0,0,0,0,0,0,0,0,0,4,0,8,304,0,25120,112,786
3148,316,316,316,316,8,308,316,308,308,308,8,8,4,4,0,0,0,0,0,0,0,0,0,0,0,4,0,8,304,0,25184,112,788
3156,316,334,316,316,72,262,264,262,262,262,22,22,22,4,0,0,0,0,0,0,0,0,0,0,0,4,18,2,240,0,25248,112,790
3164,316,321,316,316,316,5,5,5,5,5,5,5,5,0,0,0,0,0,0,0,0,0,0,0,0,0,5,0,0,0,25312,112,792
3172,316,317,316,316,12,305,305,305,305,305,9,9,5,4,0,0,0,0,0,0,0,0,0,0,0,4,1,4,296,0,25376,112,794
3180,316,381,316,316,316,65,65,65,65,65,65,65,65,0,0,0,0,0,0,0,0,0,0,0,0,0,65,0,0,0,25440,112,796
3188,316,381,316,316,181,200,202,200,200,200,68,68,68,3,0,0,0,0,0,0,0,0,0,0,0,3,65,2,132,0,25504,112,798
3196,316,316,316,316,8,308,312,308,308,308,8,8,4,4,0,0,0,0,0,0,0,0,0,0,0,4,0,6,302,0,25568,112,800
3204,316,322,316,316,316,6,6,6,6,6,6,6,6,0,0,0,0,0,0,0,0,0,0,0,0,0,6,0,0,0,25632,112,802
3212,316,316,316,316,8,308,310,308,308,308,8,8,4,4,0,0,0,0,0,0,0,0,0,0,0,4,0,5,301,0,25696,112,804
3220,316,322,316,316,316,6,6,6,6,6,6,6,6,0,0,0,0,0,0,0,0,0,0,0,0,0,6,0,0,0,25760,112,806
3228,316,335,316,316,316,19,19,19,19,19,19,19,19,0,0,0,0,0,0,0,0,0,0,0,0,0,19,0,0,0,25824,112,808
3236,316,317,316,316,316,1,1,1,1,1,1,1,1,0,0,0,0,0,0,0,0,0,0,0,0,0,1,0,0,0,25888,112,810
3244,316,322,316,316,24,298,300,298,298,298,14,14,10,4,0,0,0,0,0,0,0,0,0,0,0,4,6,5,285,0,25952,112,812
3252,316,355,316,316,316,39,39,39,39,39,39,39,39,0,0,0,0,0,0,0,0,0,0,0,0,0,39,0,0,0,26016,112,814
3260,316,320,316,316,40,280,280,280,280,280,12,12,8,4,0,0,0,0,0,0,0,0,0,0,0,4,4,4,268,0,26080,112,816
3268,316,319,316,316,316,3,3,3,3,3,3,3,3,0,0,0,0,0,0,0,0,0,0,0,0,0,3,0,0,0,26144,112,818
3276,316,316,316,316,8,308,316,308,308,308,8,8,4,4,0,0,0,0,0,0,0,0,0,0,0,4,0,8,304,0,26208,112,820
3284,316,316,316,316,8,308,316,308,308,308,8,8,4,4,0,0,0,0,0,0,0,0,0,0,0,4,0,8,304,0,26272,112,822
3292,316,316,316,316,8,308,310,308,308,308,8,8,4,4,0,0,0,0,0,0,0,0,0,0,0,4,0,5,301,0,26336,112,824
3300,316,346,316,316,316,30,30,30,30,30,30,30,30,0,0,0,0,0,0,0,0,0,0,0,0,0,30,0,0,0,26400,112,826
3308,316,329,316,316,316,13,13,13,13,13,13,13,13,0,0,0,0,0,0,0,0,0,0,0,0,0,13,0,0,0,26464,112,828
3316,316,318,316,316,316,2,2,2,2,2,2,2,2,0,0,0,0,0,0,0,0,0,0,0,0,0,2,0,0,0,26528,112,830
3324,316,362,316,316,250,112,112,112,112,112,48,48,48,2,0,0,0,0,0,0,0,0,0,0,0,2,46,0,64,0,26592,112,832
3332,316,316,316,316,8,308,310,308,308,308,8,8,4,4,0,0,0,0,0,0,0,0,0,0,0,4,0,5,301,0,26656,112,834
3340,316,319,316,316,24,295,296,295,295,295,7,7,7,4,0,0,0,0,0,0,0,0,0,0,0,4,3,1,288,0,26720,112,836
3348,316,339,316,316,316,23,23,23,23,23,23,23,23,0,0,0,0,0,0,0,0,0,0,0,0,0,23,0,0,0,26784,112,838
3356,316,322,316,316,31,291,292,291,291,291,11,11,11,4,0,0,0,0,0,0,0,0,0,0,0,4,7,1,280,0,26848,112,840
3364,316,319,316,316,16,303,307,303,303,303,7,7,7,4,0,0,0,0,0,0,0,0,0,0,0,4,3,4,296,0,26912,112,842
3372,316,318,316,316,316,2,2,2,2,2,2,2,2,0,0,0,0,0,0,0,0,0,0,0,0,0,2,0,0,0,26976,112,844
3380,316,318,316,316,316,2,2,2,2,2,2,2,2,0,0,0,0,0,0,0,0,0,0,0,0,0,2,0,0,0,27040,112,846
3388,316,316,316,316,8,308,310,308,308,308,4,4,4,4,0,0,0,0,0,0,0,0,0,0,0,4,0,2,304,0,27104,112,848
3396,316,317,316,316,12,305,307,305,305,305,9,9,5,4,0,0,0,0,0,0,0,0,0,0,0,4,1,5,297,0,27168,112,850
3404,316,320,316,316,316,4,4,4,4,4,4,4,4,0,0,0,0,0,0,0,0,0,0,0,0,0,4,0,0,0,27232,112,852
3412,316,317,316,316,316,1,1,1,1,1,1,1,1,0,0,0,0,0,0,0,0,0,0,0,0,0,1,0,0,0,27296,112,854
3420,316,316,316,316,8,308,310,308,308,308,8,8,4,4,0,0,0,0,0,0,0,0,0,0,0,4,0,5,301,0,27360,112,856
3428,316,317,316,316,12,305,307,305,305,305,9,9,5,4,0,0,0,0,0,0,0,0,0,0,0,4,1,5,297,0,27424,112,858
3436,316,316,316,316,8,308,312,308,308,308,4,4,4,4,0,0,0,0,0,0,0,0,0,0,0,4,0,4,304,0,27488,112,860
3444,316,321,316,316,24,297,299,297,297,297,9,9,9,4,0,0,0,0,0,0,0,0,0,0,0,4,5,2,288,0,27552,112,862
3452,316,316,316,316,8,308,314,308,308,308,8,8,4,4,0,0,0,0,0,0,0,0,0,0,0,4,0,7,303,0,27616,112,864
3460,316,316,316,316,316,0,0,0,0,0,0,0,0,0,0,0,0,0,0,0,0,0,0,0,0,0,0,0,0,0,27680,112,866
3468,316,316,316,316,8,308,316,308,308,308,8,8,4,4,0,0,0,0,0,0,0,0,0,0,0,4,0,8,304,0,27744,112,868
3476,316,316,316,316,8,308,312,308,308,308,4,4,4,4,0,0,0,0,0,0,0,0,0,0,0,4,0,4,304,0,27808,112,870
3484,316,322,316,316,24,298,300,298,298,298,14,14,10,4,0,0,0,0,0,0,0,0,0,0,0,4,6,5,285,0,27872,112,872
3492,316,339,316,316,316,23,23,23,23,23,23,23,23,0,0,0,0,0,0,0,0,0,0,0,0,0,23,0,0,0,27936,112,874
3500,316,318,316,316,12,306,310,306,306,306,10,10,6,4,0,0,0,0,0,0,0,0,0,0,0,4,2,6,298,0,28000,112,876
3508,316,342,316,316,56,286,289,286,286,286,30,29,29,3,0,0,0,0,0,0,0,0,0,0,0,3,26,4,256,0,28064,112,878
3516,316,333,316,316,316,17,17,17,17,17,17,17,17,0,0,0,0,0,0,0,0,0,0,0,0,0,17,0,0,0,28128,112,880
3524,316,327,316,316,316,11,11,11,11,11,11,11,11,0,0,0,0,0,0,0,0,0,0,0,0,0,11,0,0,0,28192,112,882
3532,316,324,316,316,32,292,293,292,292,292,12,12,12,4,0,0,0,0,0,0,0,0,0,0,0,4,8,1,280,0,28256,112,884
3540,316,316,316,316,8,308,310,308,308,308,8,8,4,4,0,0,0,0,0,0,0,0,0,0,0,4,0,5,301,0,28320,112,886
3548,316,316,316,316,8,308,316,308,308,308,8,8,4,4,0,0,0,0,0,0,0,0,0,0,0,4,0,8,304,0,28384,112,888
3556,316,316,316,316,8,308,316,308,308,308,8,8,4,4,0,0,0,0,0,0,0,0,0,0,0,4,0,8,304,0,28448,112,890
3564,316,320,316,316,316,4,4,4,4,4,4,4,4,0,0,0,0,0,0,0,0,0,0,0,0,0,4,0,0,0,28512,112,892
3572,316,316,316,316,8,308,316,308,308,308,8,8,4,4,0,0,0,0,0,0,0,0,0,0,0,4,0,8,304,0,28576,112,894
3580,316,386,316,316,96,290,293,290,290,290,74,74,74,4,0,0,0,0,0,0,0,0,0,0,0,4,70,3,216,0,28640,112,896
1028,1028,1028,1028,1028,24,1004,1004,1004,1004,1004,8,8,4,4,0,0,0,0,0,0,0,0,0,0,0,4,0,4,996,0,0,0,898
1036,1036,1036,1036,1036,8,1028,1028,1028,1028,1028,4,4,4,4,0,0,0,0,0,0,0,0,0,0,0,4,0,0,1024,0,0,0,900
1044,1044,1045,1044,1044,128,917,917,917,917,917,5,5,5,4,0,0,0,0,0,0,0,0,0,0,0,4,1,0,912,0,0,0,902
1052,1052,1052,1052,1052,8,1044,1045,1044,1044,1044,4,4,4,4,0,0,0,0,0,0,0,0,0,0,0,4,0,1,1040,0,0,0,904
1060,1060,1060,1060,1060,8,1052,1053,1052,1052,1052,4,4,4,4,0,0,0,0,0,0,0,0,0,0,0,4,0,1,1048,0,0,0,906
1068,1068,1068,1068,1068,1068,0,0,0,0,0,0,0,0,0,0,0,0,0,0,0,0,0,0,0,0,0,0,0,0,0,0,0,908
3636,316,322,316,316,24,298,301,298,298,298,10,10,10,4,0,0,0,0,0,0,0,0,0,0,0,4,6,3,288,0,29088,112,910
3644,316,316,316,316,8,308,309,308,308,308,4,4,4,4,0,0,0,0,0,0,0,0,0,0,0,4,0,1,304,0,29152,112,912
3652,316,316,316,316,8,308,310,308,308,308,8,8,4,4,0,0,0,0,0,0,0,0,0,0,0,4,0,5,301,0,29216,112,914
1100,1100,1100,1100,1100,8,1092,1092,1092,1092,1092,8,8,4,4,0,0,0,0,0,0,0,0,0,0,0,4,0,4,1084,0,0,0,916
1108,1108,1110,1108,1108,48,1062,1062,1062,1062,1062,6,6,6,4,0,0,0,0,0,0,0,0,0,0,0,4,2,0,1056,0,0,0,918
3676,316,326,316,316,24,302,304,302,302,302,14,14,14,4,0,0,0,0,0,0,0,0,0,0,0,4,10,2,288,0,29408,112,920
3684,316,316,316,316,8,308,312,308,308,308,4,4,4,4,0,0,0,0,0,0,0,0,0,0,0,4,0,4,304,0,29472,112,922
3692,316,316,316,316,8,308,316,308,308,308,8,8,4,4,0,0,0,0,0,0,0,0,0,0,0,4,0,8,304,0,29536,112,924
1140,1140,1140,1140,1140,24,1116,1116,1116,1116,1116,4,4,4,4,0,0,0,0,0,0,0,0,0,0,0,4,0,0,1112,0,0,0,926
1148,1148,1234,1148,1148,696,538,539,538,538,538,90,90,90,4,0,0,0,0,0,0,0,0,0,0,0,4,86,1,448,0,0,0,928
1156,1156,1157,1156,1156,88,1069,1069,1069,1069,1069,5,5,5,4,0,0,0,0,0,0,0,0,0,0,0,4,1,0,1064,0,0,0,930
1164,1164,1164,1164,1164,8,1156,1157,1156,1156,1156,4,4,4,4,0,0,0,0,0,0,0,0,0,0,0,4,0,1,1152,0,0,0,932
3732,316,316,316,316,8,308,312,308,308,308,4,4,4,4,0,0,0,0,0,0,0,0,0,0,0,4,0,4,304,0,29856,112,934
3740,316,320,316,316,23,297,298,297,297,297,9,9,9,4,0,0,0,0,0,0,0,0,0,0,0,4,5,1,288,0,29920,112,936
3748,316,349,316,316,316,33,33,33,33,33,33,33,33,0,0,0,0,0,0,0,0,0,0,0,0,0,33,0,0,0,29984,112,938
1196,1196,1196,1196,1196,8,1188,1190,1188,1188,1188,8,8,4,4,0,0,0,0,0,0,0,0,0,0,0,4,0,5,1181,0,0,0,940
1204,1204,1204,1204,1204,12,1192,1192,1192,1192,1192,8,8,4,4,0,0,0,0,0,0,0,0,0,0,0,4,0,4,1184,0,0,0,942
3772,316,318,316,316,316,2,2,2,2,2,2,2,2,0,0,0,0,0,0,0,0,0,0,0,0,0,2,0,0,0,30176,112,944
1220,1220,1221,1220,1220,1220,1,1,1,1,1,1,1,1,0,0,0,0,0,0,0,0,0,0,0,0,0,1,0,0,0,0,0,946
1228,1228,1228,1228,1228,1228,0,0,0,0,0,0,0,0,0,0,0,0,0,0,0,0,0,0,0,0,0,0,0,0,0,0,0,948
1236,1236,1250,1236,1236,1236,14,14,14,14,14,14,14,14,0,0,0,0,0,0,0,0,0,0,0,0,0,14,0,0,0,0,0,950
1244,1244,1248,1244,1244,24,1224,1224,1224,1224,1224,8,8,8,4,0,0,0,0,0,0,0,0,0,0,0,4,4,0,1216,0,0,0,952
1252,1252,1252,1252,1252,8,1244,1244,1244,1244,1244,8,8,4,4,0,0,0,0,0,0,0,0,0,0,0,4,0,4,1236,0,0,0,954
1260,1260,1263,1260,1260,1260,3,3,3,3,3,3,3,3,0,0,0,0,0,0,0,0,0,0,0,0,0,3,0,0,0,0,0,956
1268,1268,1268,1268,1268,24,1244,1245,1244,1244,1244,4,4,4,4,0,0,0,0,0,0,0,0,0,0,0,4,0,1,1240,0,0,0,958
1276,1276,1292,1276,1276,192,1100,1104,1100,1100,1100,20,20,20,4,0,0,0,0,0,0,0,0,0,0,0,4,16,4,1080,0,0,0,960
1284,1284,1284,1284,1284,8,1276,1276,1276,1276,1276,8,8,4,4,0,0,0,0,0,0,0,0,0,0,0,4,0,4,1268,0,0,0,962
1292,1292,1292,1292,1292,24,1268,1268,1268,1268,1268,4,4,4,4,0,0,0,0,0,0,0,0,0,0,0,4,0,0,1264,0,0,0,964
1300,1300,1300,1300,1300,8,1292,1294,1292,1292,1292,4,4,4,4,0,0,0,0,0,0,0,0,0,0,0,4,0,2,1288,0,0,0,966
3868,316,325,316,316,24,301,304,301,301,301,13,13,13,4,0,0,0,0,0,0,0,0,0,0,0,4,9,3,288,0,30944,112,968
3876,316,384,316,316,175,209,210,209,209,209,71,71,71,3,0,0,0,0,0,0,0,0,0,0,0,3,68,1,138,0,31008,112,970
3884,316,342,316,316,316,26,26,26,26,26,26,26,26,0,0,0,0,0,0,0,0,0,0,0,0,0,26,0,0,0,31072,112,972
1332,1332,1332,1332,1332,24,1308,1308,1308,1308,1308,4,4,4,4,0,0,0,0,0,0,0,0,0,0,0,4,0,0,1304,0,0,0,974
3900,316,320,316,316,316,4,4,4,4,4,4,4,4,0,0,0,0,0,0,0,0,0,0,0,0,0,4,0,0,0,31200,112,976
1348,1348,1348,1348,1348,8,1340,1340,1340,1340,1340,4,4,4,4,0,0,0,0,0,0,0,0,0,0,0,4,0,0,1336,0,0,0,978
3916,316,370,316,316,242,128,128,128,128,128,56,56,56,2,0,0,0,0,0,0,0,0,0,0,0,2,54,0,72,0,31328,112,980
1364,1364,1364,1364,1364,40,1324,1324,1324,1324,1324,4,4,4,4,0,0,0,0,0,0,0,0,0,0,0,4,0,0,1320,0,0,0,982
1372,1372,1372,1372,1372,8,1364,1368,1364,1364,1364,8,8,4,4,0,0,0,0,0,0,0,0,0,0,0,4,0,6,1358,0,0,0,984
1380,1380,1456,1380,1380,1380,76,76,76,76,76,76,76,76,0,0,0,0,0,0,0,0,0,0,0,0,0,76,0,0,0,0,0,986
